emoji	keywords
тМЪя╕П	clock, time, watch, роХроЯро┐роХро╛ро░роорпН, роирпЗро░роорпН, ро╡ро╛роЯрпНроЪрпН
тМЫя╕П	done, hourglas, hourglass, sand, time, timer, роХроЯро┐роХро╛ро░роорпН, роирпЗро░роорпН, роорогро▒рпНроХроЯро┐роХро╛ро░роорпН, роорогро▓рпН
тП░я╕П	alarm, clock, hour, hours, hrs, late, time, waiting, роЕро▓ро╛ро░, роЕро▓ро╛ро░роорпН, роХроЯро┐роХро╛ро░роорпН, роорпЗроЪрпИ
тП│я╕П	done, flowing, hour, hourglas, hourglass, hours, not, sand, timer, waiting, yolo, роХроЯро┐роХро╛ро░роорпН, роХро╛ро▓роХрпНроХрпЖроЯрпБ, роЪро░ро┐ропрпБроорпН, роирпЗро░роорпН, роорогро▒рпНроХроЯро┐роХро╛ро░роорпН, роорогро▓рпБроЯройрпН, ропрпЛро▓рпЛ
тШФя╕П	clothing, drop, drops, rain, umbrella, weather, роХрпБроЯрпИ, родрпБро│ро┐, родрпБро│ро┐роХро│рпБроЯройрпН, рооро┤рпИ, рооро┤рпИродрпН
тШХя╕П	beverage, cafe, caffeine, chai, coffee, drink, hot, morning, steaming, tea, роХро╛рокро┐, роХро╛рокро┐роЯрпЗ, роЪрпВроЯро╛рой, роЯрпА, рокро╛ройроорпН, ро╕рпНроЯро╛ро░рпНрокроХрпНро╕рпН
тЪУя╕П	anchor, ship, tool, роЖроЩрпНроХро░рпН, роХроЯро▓рпН, роХрокрпНрокро▓рпН, роХро░рпБро╡ро┐, роироЩрпНроХрпВро░роорпН
тЪбя╕П	danger, electric, electricity, high, lightning, nature, thunder, thunderbolt, voltage, zap, роЕрокро╛ропроорпН, роЗроЯро┐, роЙропро░рпН, роЪро┐ройрпНройроорпН, рооро┐ройрпНроЪро╛ро░роорпН, рооро┐ройрпНройродро┐ро░рпНро╡рпБ, рооро┐ройрпНройро▓рпН, рооро┐ройрпНройро┤рпБродрпНрод, рооро┐ройрпНройро┤рпБродрпНродроорпН
тЪ╜я╕П	ball, football, futbol, soccer, sport, роХро╛ро▓рпНрокроирпНродрпБ, роЪро╛роХрпНроХро░рпН, роорпЖро╕рпНро╕ро┐, ро░рпКройро╛ро▓рпНроЯрпЛ, ро╡ро┐ро│рпИропро╛роЯрпНроЯрпБ
тЪ╛я╕П	ball, baseball, sport, рокроирпНродрпБ, рокрпЗро╕рпНрокро╛ро▓рпН, ро╡ро┐ро│рпИропро╛роЯрпНроЯрпБ
тЫДя╕П	cold, man, snow, snowman, роЗро▓рпНро▓ро╛род, роХро╛ро░рпНроЯрпНроЯрпВройрпН, роХрпБро│ро┐ро░рпНроХро╛ро▓роорпН, рокройро┐, рокройро┐рокрпНрокрпКро┤ро┐ро╡рпБ, рооройро┐родройрпН, ро╡рпЖрокрпНрокроиро┐ро▓рпИ, ро╕рпНроирпЛроорпЗройрпН, ро╕рпНройрпЛроорпЗройрпН
тЫЕя╕П	behind, cloud, cloudy, sun, weather, роЗропро▒рпНроХрпИ, роХро╛роЯрпНроЪро┐, роЪрпВро░ро┐ропройрпИ, роЪрпВро░ро┐ропройрпН, рокро┐ройрпНройро╛ро▓рпН, рокрпЛройрпНро▒, рооро▒рпИроирпНродро┐ро░рпБроХрпНроХрпБроорпН, роорпВроЯро┐ропро┐ро░рпБроХрпНроХрпБроорпН, роорпВроЯро┐ропро┐ро░рпБрокрпНрокродрпБ, роорпЗроХродрпНродро┐ройрпН, роорпЗроХроорпН
тЫУя╕ПтАНЁЯТе	break, breaking, broken, chain, cuff, cuffs, freedom, роЙроЯрпИродрпНродро▓рпН, роЙроЯрпИроирпНрод, роЙроЯрпИрокрпНрокрпБ, роХроГрокрпНро╕рпН, роЪроЩрпНроХро┐ро▓ро┐, роЪрпБродроирпНродро┐ро░роорпН
тЫкя╕П	bles, bless, chapel, christian, church, cros, cross, religion, роЖро▓ропроорпН, роХроЯро╡рпБро│рпН, роХрпЛропро┐ро▓рпН, роЪро┐ро▓рпБро╡рпИ, родрпЗро╡ро╛ро▓ропроорпН, рокро┐ро░ро╛ро░рпНродрпНродройрпИ, роородроорпН
тЫ▓я╕П	fountain, родрпЛроЯрпНроЯроорпН, роирпАро░рпБро▒рпНро▒рпБ, рокрпВроЩрпНроХро╛
тЫ│я╕П	flag, golf, hole, in, sport, роХрпКроЯро┐, роХрпЛро▓рпНроГрокрпН, ро╡ро┐ро│рпИропро╛роЯрпНроЯрпБ
тЫ╡я╕П	boat, resort, sailboat, sailing, sea, yacht, роЙро▓ро╛рокрпН, роХроЯро▓рпН, роЪрпБро▒рпНро▒рпБро▓ро╛, рокроЯроХрпБ, рокропрогроорпН, ро░ро┐роЪро╛ро░рпНроЯрпН
тЫ╣я╕ПтАНтЩАя╕П	athletic, ball, basketball, bouncing, championship, dribble, net, player, throw, woman, роХрпИрокрпНрокроирпНродрпБ, роирокро░рпН, рокроирпНродро╛роЯрпБроорпН, рокроирпНродрпБ, рокро╛ро▓рпН, рокрпЖрогрпН, ро╡ро╛ро▓ро┐, ро╡ро┐ро│рпИропро╛роЯрпНроЯрпБ
тЫ╣я╕ПтАНтЩВя╕П	athletic, ball, basketball, bouncing, championship, dribble, man, net, player, throw, роЖрогрпН, рокроирпНродро╛роЯрпБроорпН, рокроирпНродрпБ, ро╡ро┐ро│рпИропро╛роЯрпНроЯрпБ
тЫ║я╕П	camping, tent, роХрпВроЯро╛ро░роорпН, роХрпЗроорпНрокрпН, роХрпЗроорпНрокрпНрокро┐роЩрпН, рокропро┐ро▒рпНроЪро┐, роорпБроХро╛роорпН
тЫ╜я╕П	diesel, fuel, fuelpump, gas, gasoline, pump, station, роОро░ро┐рокрпКро░рпБро│рпН, роОро░ро┐ро╡ро╛ропрпБ, роХрпЗро╕рпЛро▓ро┐ройрпН, роиро┐ро▓рпИропроорпН, рокроЩрпНроХрпН
тЬия╕П	magic, sparkle, sparkles, star, роТро│ро┐ро░рпБроорпН, роХрпКрогрпНроЯро╛роЯрпНроЯроорпН, роироЯрпНроЪродрпНродро┐ро░роорпН
тнРя╕П	astronomy, medium, star, stars, white, роироЯрпНроЪродрпНродро┐ро░роорпН, роиро┐ро▒, ро╡рпЖро│ро┐ро░рпНроиро┐ро▒, ро╡рпЖро│рпНро│рпИ, ро╕рпНроЯро╛ро░рпН
ЁЯАДя╕П	dragon, game, mahjong, red, роЯро┐ро░ро╛роХройрпН, роЯрпИро▓ро┐ро▓рпН, рооро╣рпНроЬрпЛроЩрпН, ро░рпЖроЯрпН, ро╡ро┐ро│рпИропро╛роЯрпНроЯрпБ
ЁЯГП	card, game, joker, wildcard, роЕроЯрпНроЯрпИропро┐ро▓рпН, роХро░рпБрокрпНрокрпБ, роЪрпАроЯрпНроЯрпБ, роЪрпАроЯрпНроЯрпБроХрпНроХроЯрпНроЯрпБ, роЬрпЛроХрпНроХро░рпН, ро╡рпИро▓рпНроЯрпБроХро╛ро░рпНроЯрпБ
ЁЯМА	cyclone, dizzy, hurricane, twister, typhoon, weather, роГрокро┐ро│ро╛ро╖рпНрокрпЗроХрпН, роХро┐ро▒рпБроХро┐ро▒рпБрокрпНрокрпБ, роЪрпБро┤ро▒рпНроХро╛ро▒рпНро▒рпБ, родро▓рпИроЪрпНроЪрпБро▒рпНро▒ро▓рпН, роиро┐ройрпИро╡рпБ, рокро┤рпИроп, рокро┐ро│ро╛ро╖рпНрокрпЗроХрпН, рокрпБропро▓рпН, рооропроХрпНроХроорпН
ЁЯМБ	fog, foggy, роГрокро╛роХрпН, рокройро┐, рокройро┐рокрпНрокрпБроХрпИ, рокройро┐роорпВроЯрпНроЯроорпН, ро╡рпЖрогрпНрокрпБроХрпИ
ЁЯМВ	closed, clothing, rain, umbrella, роХрпБроЯрпИ, рооро┤рпИ, роорпВроЯро┐роп, ро╡рпЖропро┐ро▓рпН
ЁЯМГ	night, star, stars, роЗро░ро╡ро┐ро▓рпН, роЗро░ро╡рпБ, роироХро░роорпН, роироЯрпНроЪродрпНродро┐ро░роЩрпНроХро│рпН, роироЯрпНроЪродрпНродро┐ро░роорпН, роирпЗро░, рооро┐ро│ро┐ро░рпБроорпН, ро╡ро╛ройроорпН
ЁЯМД	morning, mountain, mountains, over, sun, sunrise, роЙродропроЪрпВро░ро┐ропройрпН, роХро╛ро▓рпИ, роХро╛ро▓рпИроЪрпНроЪрпВро░ро┐ропройрпН, роЪрпВро░ро┐ропрпЛродропроорпН, рооро▓рпИ, ро╡рпЖропро┐ро▓рпН
ЁЯМЕ	morning, nature, sun, sunrise, роЖродро╡ройрпН, роЙродропроорпН, роХроЯро▓рпБроорпН, роХро╛ро▓рпИ, роХро╛ро▓рпИроЪрпНроЪрпВро░ро┐ропройрпН, роЪрпВро░ро┐роп, роЪрпВро░ро┐ропройрпБроорпН, роЪрпВро░ро┐ропройрпН, роЪрпВро░ро┐ропрпЛродропроорпН
ЁЯМЖ	at, building, city, cityscape, dusk, evening, landscape, sun, sunset, роЕро╕рпНродрооройродрпНродро┐ройрпН, роЕро╕рпНродрооройроорпН, роЪрпВро░ро┐роп, роироХро░роорпН, рокрпЛродрпБ, рооро╛ро▓рпИ
ЁЯМЗ	building, dusk, sun, sunset, роЕро╕рпНродрооройроорпН, роЪрпВро░ро┐роп, роироХро░родрпНродро┐ро▓рпН, роирпЗро░, рооро╛ро▓рпИ, роорпБроЯро┐ро╡рпБ, ро╡рпЗро▓рпИ
ЁЯМИ	gay, genderqueer, glbt, glbtq, lesbian, lgbt, lgbtq, lgbtqia, nature, pride, queer, rain, rainbow, tran, trans, transgender, weather, роЗро░рпБрокро╛ро▓ро┐ройродрпНродро╡ро░рпН, роУро░ро┐ройроЪрпНроЪрпЗро░рпНроХрпНроХрпИропро╛ро│ро░рпН, роХрпЗ, ро▓рпЖро╕рпНрокро┐ропройрпН, ро╡рогрпНрогроорпН, ро╡ро╛ройро╡ро┐ро▓рпН
ЁЯМЙ	at, bridge, night, роЗро░ро╡ро┐ройрпН, роЗро░ро╡ро┐ро▓рпН, роЗро░ро╡рпБ, рокро╛ро▓роорпН, рокро┐ройрпНройрогро┐ропро┐ро▓рпН
ЁЯМК	nature, ocean, surf, surfer, surfing, water, wave, роЕро▓рпИ, роУроЪрпИ, роХроЯро▓ро▓рпИ, роХроЯро▓рпН, роЪро░рпНроГрокро┐роЩрпН, роЪрпАро▒рпНро▒роорпН, роирпАро░ро▓рпИ
ЁЯМЛ	eruption, mountain, nature, volcano, роОро░ро┐рооро▓рпИ, роирпЖро░рпБрокрпНрокрпБ, ро▓ро╛ро╡ро╛, ро╡ро▓рпНроХройрпЛ, ро╡рпЖроЯро┐роХрпНроХрпБроорпН, ро╡рпЖроЯро┐рокрпНрокрпБ
ЁЯММ	milky, space, way, роЕрогрпНроЯроорпН, роЗро░ро╡рпБ, рокро╛ро▓рпНро╡ро┤ро┐, рокро┐ро░рокроЮрпНроЪроорпН
ЁЯМНя╕П	africa, earth, europe, globe, showing, world, роЖрокрпНрокро┐ро░ро┐роХрпНроХро╛, роЙро░рпБрогрпНроЯрпИ, роЙро▓роХ, роРро░рпЛрокрпНрокро╛, рокроирпНродрпБ, рокрпВрооро┐
ЁЯМОя╕П	america, americas, earth, globe, showing, world, роЕроорпЖро░ро┐роХрпНроХро╛, роЙро░рпБрогрпНроЯрпИ, роЙро▓роХ, родрпЖройрпН, рокрпВрооро┐, рокрпВрооро┐рокрпНрокроирпНродрпБ, ро╡роЯ
ЁЯМПя╕П	asia, australia, earth, globe, showing, world, роЖроЪро┐ропро╛, роЖро╕рпНродро┐ро░рпЗро▓ро┐ропро╛, роЙро░рпБрогрпНроЯрпИ, роЙро▓роХ, рокрпВрооро┐, рокрпВрооро┐рокрпНрокроирпНродрпБ
ЁЯМР	earth, globe, internet, meridian, meridians, web, world, worldwide, роЕроЯрпНроЪро░рпЗроХрпИ, роЙро░рпБрогрпНроЯрпИ, роЙро▓роХ, родрпАро░рпНроХрпНроХро░рпЗроХрпИ, родрпАро░рпНроХрпНроХро░рпЗроХрпИроХро│рпБроЯройрпН, рокрпВрооро┐
ЁЯМС	dark, moon, new, space, роЕрооро╛ро╡роЪрпИ, роЗро░ро╡рпБ, роЗро░рпБро│рпН, роиро┐ро▓ро╛
ЁЯМТ	crescent, dream, dreams, moon, space, waxing, роЗро░ро╡рпБ, роиро┐ро▓ро╛, рокро┐ро▒рпИроиро┐ро▓ро╡рпБ, ро╡ро│ро░рпНрокро┐ро▒рпИ
ЁЯМУ	first, moon, quarter, space, роЕро░рпИроиро┐ро▓ро╡рпБ, роЕро░рпИрокро╛родро┐, роЗро░ро╡рпБ, роиро┐ро▓ро╛, ро╡ро│ро░рпНрокро┐ро▒рпИ
ЁЯМФ	gibbou, gibbous, moon, space, waxing, роЗро░ро╡рпБ, роиро┐ро▓ро╡рпКро│ро┐, роиро┐ро▓ро╛, рокро┐ро▒рпИроиро┐ро▓ро╡рпБ, роорпБроХрпНроХро╛ро▓рпНрокроХрпБродро┐, ро╡ро│ро░рпНрокро┐ро▒рпИ
ЁЯМХя╕П	full, moon, space, роЗро░ро╡рпБ, роиро┐ро▓ро╡рпКро│ро┐, рокро╡рпБро░рпНрогрооро┐, рокрпМро░рпНрогрооро┐, роорпБро┤рпБроиро┐ро▓ро╡рпБ
ЁЯМЦ	gibbou, gibbous, moon, space, waning, роЗро░ро╡рпБ, роХро╛ро▓рпНрокроХрпБродро┐, родрпЗропрпНрокро┐ро▒рпИ, роиро┐ро▓ро╡рпКро│ро┐, роиро┐ро▓ро╛
ЁЯМЧ	last, moon, quarter, space, роЕро░рпИроиро┐ро▓ро╡рпБ, роЕро░рпИрокро╛родро┐, роЗро░ро╡рпБ, родрпЗропрпНрокро┐ро▒рпИ, роиро┐ро▓ро╛
ЁЯМШ	crescent, moon, space, waning, роЗро░ро╡рпБ, родрпЗропрпНрокро┐ро▒рпИ, роиро┐ро▓ро╛, рокро┐ро▒рпИроиро┐ро▓ро╡рпБ, роорпБроХрпНроХро╛ро▓рпНрокроХрпБродро┐
ЁЯМЩ	crescent, moon, ramadan, space, родрпЗропрпНрокро┐ро▒рпИ, роиро┐ро▓ро╡рпКро│ро┐, роиро┐ро▓ро╛, рокро┐ро▒рпИроиро┐ро▓ро╡рпБ, ро░роородро╛ройрпН, ро░рооро▓ро╛ройрпН, ро░роорпНроЬро╛ройрпН, ро╡ро│ро░рпНрокро┐ро▒рпИ
ЁЯМЪ	moon, new, space, роЕрооро╛ро╡ро╛роЪрпИ, роХро░рпБрокрпНрокрпБ, роиро┐ро▓ро╛, роорпБроХроорпН
ЁЯМЫ	first, moon, quarter, space, роЕро░рпИрокро╛родро┐, роиро┐ро▓ро╛, роорпБроХроорпН, ро╡ро│ро░рпНрокро┐ро▒рпИ
ЁЯМЬя╕П	dream, dreams, last, moon, quarter, роЕро░рпИрокро╛родро┐, родрпЗропрпНрокро┐ро▒рпИ, роиро┐ро▓ро╛, роорпБроХроорпН
ЁЯМЭ	bright, full, moon, роиро┐ро▓ро╛, рокро┐ро░роХро╛роЪроорпН, рокрпМро░рпНрогрооро┐, роорпБроХроорпН, роорпБро┤рпБроиро┐ро▓ро╛
ЁЯМЮ	beach, bright, day, heat, shine, sun, sunny, sunshine, weather, роТро│ро┐, роХроЯро╡рпБро│рпН, роХрпЛроЯрпИ, роЪрпВро░ро┐роп, роЪрпВро░ро┐ропроХрпН, роЪрпВро░ро┐ропройрпН, роорпБроХроорпН, ро╡рпЖрокрпНрокроорпН, ро╡рпЖропро┐ро▓рпН, ро╡рпЖро│ро┐роЪрпНроЪроорпН
ЁЯМЯ	glittery, glow, glowing, night, shining, sparkle, star, win, роТро│ро┐, родро┐ро▒роорпИ, роироЯрпНроЪродрпНродро┐ро░роорпН, ро╡рпАроЪрпБроорпН
ЁЯМа	falling, night, shooting, space, star, роЗро░ро╡рпБ, роОро░ро┐роироЯрпНроЪродрпНродро┐ро░роорпН, роироЯрпНроЪродрпНродро┐ро░роорпН, ро╡ро╛ро▓рпН, ро╡ро┐рогрпНро╡рпЖро│ро┐
ЁЯМн	dog, frankfurter, hot, hotdog, sausage, роЗро▒рпИроЪрпНроЪро┐, роЙрогро╡рпБ, роХрпКродрпНродрпБроХрпНроХро▒ро┐, роЪро╛ро╕рпЗроЬрпН, роЯро╛роХрпН, ро╣ро╛роЯрпН, ро╣ро╛роЯрпНроЯро╛роХрпН
ЁЯМо	mexican, taco, роЙрогро╡рпБ, роЯро╛роХрпЛ, роорпЖроХрпНроЪро┐роХройрпН, роорпЖроХрпНро╕ро┐роХройрпН
ЁЯМп	burrito, mexican, wrap, роЙрогро╡рпБ, роХродрпНродро┐, роЪрокрпНрокро╛родрпНродро┐, рокро░ро┐роЯрпНроЯрпЛ, рокрпБро░ро┐роЯрпНроЯрпЛ, роорпЖроХрпНроЪро┐роХройрпН, роорпЖроХрпНро╕ро┐роХройрпН, ро░рпЛро▓рпН
ЁЯМ░	almond, chestnut, plant, роЙрогро╡рпБ, роЪрпЖро╕рпНроЯрпНроироЯрпН, роироЯрпНро╕рпН, рокро╛родро╛роорпН, ро╡ро▒рпБродрпНрод
ЁЯМ▒	plant, sapling, seedling, sprout, young, роЪрпЖроЯро┐, родрпКроЯроХрпНроХроорпН, рокрпБродро┐роп, роорпБро│рпИ, роорпБро│рпИроХрпНроХрпБроорпН, ро╡ро│ро░рпНроЪрпНроЪро┐
ЁЯМ▓	christma, christmas, evergreen, forest, pine, tree, роЕроЪрпЛроХ, роХро╛ро▓роорпН, роХро┐ро▒ро┐ро╕рпНродрпБрооро╕рпН, рокроЪрпБроорпИ, рокрпИройрпН, рооро░роорпН
ЁЯМ│	deciduou, deciduous, forest, green, habitat, shedding, tree, роЗро▓рпИропрпБродро┐ро░рпН, роХро╛роЯрпБ, рокроЪрпБроорпИ, рооро░роорпН
ЁЯМ┤	beach, palm, plant, tree, tropical, роХроЯро▒рпНроХро░рпИ, роХрпЗро│ро┐роХрпНроХрпИ, рокройрпИ, рокрпАроЪрпН, рооро░роорпН, ро╡ро┐роЯрпБроорпБро▒рпИ
ЁЯМ╡	cactu, cactus, desert, drought, nature, plant, роХро▒рпНро▒ро╛ро┤рпИ, роХро│рпНро│ро┐, роЪрокрпНрокро╛родрпНродро┐, роЪрпЖроЯро┐, рокро╛ро▓рпИро╡ройроорпН
ЁЯМ╖	blossom, flower, growth, plant, tulip, роЗро▓рпИроХро│рпН, роЪрпЖроЯро┐, роЯрпНропрпБро▓ро┐рокрпН, рокрпВ, рокрпВро╡ро░роЪрпБ, рооро▓ро░рпН, ро░рпЛроЬро╛, ро░рпЛро╕рпН
ЁЯМ╕	blossom, cherry, flower, plant, spring, springtime, роХро╛ро▓роорпН, роЪрпЖро░рпНро░ро┐, роЪрпЖро░рпНро░ро┐рокро┐ро▓ро╛ро╕роорпН, рокро┐ро▓ро╛ро╕роорпН, рооро▓ро░рпН, ро╡роЪроирпНрод, ро╡роЪроирпНродроорпН
ЁЯМ╣	beauty, elegant, flower, love, plant, red, rose, valentine, роХро╛родро▓рпН, роЪро┐ро╡рокрпНрокрпБ, рооро▓ро░рпН, ро░рпЛроЬро╛
ЁЯМ║	flower, hibiscu, hibiscus, plant, роЪрпЖроорпНрокро░рпБродрпНродро┐, рокрпВ, рооро▓ро░рпН
ЁЯМ╗	flower, outdoor, outdoors, plant, sun, sunflower, роЪрпВро░ро┐ропроХро╛роирпНродро┐, роЪрпВро░ро┐ропройрпН, рокрпВ, рооро▓ро░рпН
ЁЯМ╝	blossom, buttercup, dandelion, flower, plant, роЯрпЗройрпНроЯрпЗро▓ро┐ропройрпН, рокро┐ро▓ро╛ро╕роорпН, роороЮрпНроЪро│рпН, рооро▓ро░рпН
ЁЯМ╜	corn, crop, crops, ear, farm, maize, maze, of, роЙрогро╡рпБ, роХро╛ро░рпНройрпН, роЪрпЛро│роХрпНроХродро┐ро░рпН, роЪрпЛро│роорпН, рокро╛рокрпНроХро╛ро░рпНройрпН, роороХрпНроХро╛роЪрпНроЪрпЛро│роорпН, ро╕рпНро╡рпАроЯрпНроХро╛ро░рпНройрпН
ЁЯМ╛	ear, grain, grains, of, plant, rice, sheaf, роЕро░ро┐роЪро┐, роЕро▒рпБро╡роЯрпИ, роирпЖро▒рпНроХродро┐ро░рпН, роирпЖро▓рпН, ро╡ропро▓рпН
ЁЯМ┐	herb, leaf, plant, роЗро▓рпИ, роЗро▓рпИроХро│рпН, роЪрпЖроЯро┐, рокроЪрпБроорпИ, рокроЪрпНроЪрпИ, рооро░рпБроирпНродрпБ, роорпВро▓ро┐роХрпИ
ЁЯНА	clover, four, irish, leaf, lucky, plant, роЕродро┐ро░рпНро╖рпНроЯроорпН, роЗро▓рпИ, роЗро▓рпИроХро│рпН, роХро┐ро│ро╛ро╡ро░рпН, роХро┐ро│рпЛро╡ро░рпН, роХрпНро│рпЛро╡ро░рпН, роиро╛ройрпНроХрпБ
ЁЯНБ	falling, leaf, maple, роЗро▓рпИ, роЗро▓рпИропрпБродро┐ро░рпН, роЗро▓рпИропрпБродро┐ро░рпНроХро╛ро▓роорпН, роорпЗрокрпНрокро┐ро│рпН
ЁЯНВ	autumn, fall, fallen, falling, leaf, роЗро▓рпИроХро│рпН, роЗро▓рпИропрпБродро┐ро░рпН, роЗро▓рпИропрпБродро┐ро░рпНроХро╛ро▓роорпН, роЙродро┐ро░рпБроорпН, ро╡ро▒роЯрпНроЪро┐
ЁЯНГ	blow, flutter, fluttering, in, leaf, wind, роЖроЯрпБроорпН, роЗро▓рпИроХро│рпН, роЗро▓рпИропрпБродро┐ро░рпНроХро╛ро▓роорпН, роЙродро┐ро░рпБроорпН, роХро╛ро▒рпНро▒ро┐ро▓рпН, рокроЪрпБроорпИ
ЁЯНД	fungu, fungus, mushroom, toadstool, роЙрогро╡рпБ, роХро╛ро│ро╛ройрпН, роЪрпВрокрпНрокро░рпН, роиро╛ропрпНроХрпНроХрпБроЯрпИ, рооро╖рпНро░рпВроорпН, рооро╛ро░ро┐ропрпЛ
ЁЯНДтАНЁЯЯл	brown, food, fungi, fungu, fungus, mushroom, nature, pizza, portobello, shiitake, shroom, spore, sprout, topping, toppings, truffle, vegetable, vegetarian, veggie, роЗропро▒рпНроХрпИ, роЙрогро╡рпБ, роХро╛ропрпНроХро▒ро┐, роХро╛ро│ро╛ройрпН, роЪрпИро╡, роЯро╛рокрпНрокро┐роЩрпН, роиро┐ро▒, рокро┤рпБрокрпНрокрпБ, рокрпАроЯрпНроЪро╛, рокрпВроЮрпНроЪрпИ
ЁЯНЕ	food, fruit, tomato, vegetable, роЙрогро╡рпБ, роХро╛ропрпН, роХро╛ропрпНроХро▒ро┐, родроХрпНроХро╛ро│ро┐, рокро┤роорпН
ЁЯНЖ	aubergine, eggplant, vegetable, роЙрогро╡рпБ, роХродрпНродро░ро┐, роХродрпНродро░ро┐роХрпНроХро╛ропрпН, роХро╛ропрпН, роХро╛ропрпНроХро▒ро┐
ЁЯНЗ	dionysu, dionysus, fruit, grape, grapes, роЙрогро╡рпБ, роТропро┐ройрпН, родро┐ро░ро╛роЯрпНроЪрпИ, рокро┤роорпН, рокро┤ро░роЪроорпН
ЁЯНИ	cantaloupe, fruit, melon, роЙрогро╡рпБ, родро╛роХроорпН, рокро┤роорпН, роорпБро▓ро╛роорпНрокро┤роорпН, роорпЖро▓ройрпН
ЁЯНЙ	fruit, watermelon, роЙрогро╡рпБ, роХрпЛроЯрпИроХро╛ро▓роорпН, родро░рпНрокрпВроЪрогро┐, родро╛роХроорпН, рокро┤роорпН, роорпЖро▓ройрпН, ро╡ро╛роЯрпНроЯро░рпН
ЁЯНК	citru, citrus, fruit, nectarine, orange, tangerine, vitamin, роЖро░роЮрпНроЪрпБ, роЖро░роЮрпНроЪрпБрокрпНрокро┤роорпН, роЙроЯро▓рпНроиро▓роорпН, роЙрогро╡рпБ, роЪро┐, роЪро┐роЯрпНро░ро╕рпН, рокро┤роорпН, ро╡рпИроЯрпНроЯрооро┐ройрпН
ЁЯНЛ	citru, citrus, fruit, lemon, sour, роЙрогро╡рпБ, роОро▓рпБрооро┐роЪрпНроЪрпИ, рокро┤роорпН, рокрпБро│ро┐рокрпНрокрпБ, роороЮрпНроЪро│рпН, ро╡рогрпНрогроорпН
ЁЯНЛтАНЁЯЯй	acidity, citru, citrus, cocktail, fruit, garnish, key, lime, margarita, mojito, refreshing, salsa, sour, tangy, tequila, tropical, zest, роЕро▓роЩрпНроХро╛ро░роорпН, роЙрогро╡рпБ, роОро▓рпБрооро┐роЪрпНроЪрпИ, роЪро╛родрпНродрпБроХрпНроХрпБроЯро┐, роЪро┐роЯрпНро░ро╕рпН, роЬрпВро╕рпН, рокро┤роЪрпНроЪро╛ро▒рпБ, рокро┤роорпН, рокро╛ройроорпН, рокрпБро│ро┐рокрпНрокрпБ, ро╡рпЖрокрпНрокроорогрпНроЯро▓роорпН
ЁЯНМ	banana, fruit, potassium, роЙроЯро▓рпНроиро▓роорпН, роЙрогро╡рпБ, рокро┤роорпН, рокрпКроЯрпНроЯро╛роЪро┐ропроорпН, ро╡ро╛ро┤рпИ, ро╡ро╛ро┤рпИрокрпНрокро┤роорпН
ЁЯНН	colada, fruit, pina, pineapple, tropical, роЕройрпНройро╛роЪро┐, роЕройрпНройро╛роЪро┐рокрпНрокро┤роорпН, роЙроЯро▓рпНроиро▓роорпН, роЙрогро╡рпБ, рокро┤роорпН, рокрпИройро╛рокрпНрокро┐ро│рпН
ЁЯНО	apple, diet, food, fruit, health, red, ripe, роЖрокрпНрокро┐ро│рпН, роЙроЯро▓рпНроиро▓роорпН, роЙрогро╡рпБ, роЪро┐ро╡рокрпНрокрпБ, рокро┤роорпН
ЁЯНП	apple, fruit, green, роЖрокрпНрокро┐ро│рпН, роЙрогро╡рпБ, рокроЪрпНроЪрпИ, рокро┤роорпН
ЁЯНР	fruit, pear, роЙрогро╡рпБ, рокро┤роорпН, рокро┐ропро░рпН, рокрпЗро░ро┐роХрпНроХро╛ропрпН
ЁЯНС	fruit, peach, роЙрогро╡рпБ, рокро┤роорпН, рокрпАроЪрпН
ЁЯНТ	berries, berry, cherries, cherry, fruit, red, роЙрогро╡рпБ, роЪро┐ро╡рокрпНрокрпБ, роЪрпЖро░рпНро░ро┐, рокро┤роорпН
ЁЯНУ	berry, fruit, strawberry, роЙрогро╡рпБ, рокро┤роорпН, рокрпЖро░рпНро░ро┐, ро╕рпНроЯрпНро░ро╛рокрпЖро░рпНро░ро┐
ЁЯНФ	burger, eat, fast, food, hamburger, hungry, роЙрогро╡роХроорпН, роЙрогро╡рпБ, рокро░рпНроХро░рпН, ро╣роорпНрокро░рпНроХро░рпН
ЁЯНХ	cheese, food, hungry, pepperoni, pizza, slice, роЙрогро╡рпБ, роЪрпАро╕рпН, родрпБрогрпНроЯрпБ, родрпБро░ро┐род, рокроЪро┐, рокрпАроЯрпНроЪро╛, рокрпАроЯрпНро╕ро╛, рокрпЖрокрпНрокро░рпЛройро┐
ЁЯНЦ	bone, meat, on, роЙрогро╡роХроорпН, роЙрогро╡рпБ, роОро▓рпБроорпНрокрпБ, рооро╛рооро┐роЪроорпН, ро╡ро┐ро░рпБроирпНродрпБ
ЁЯНЧ	bone, chicken, drumstick, hungry, leg, poultry, turkey, роЙрогро╡рпБ, роОро▓рпБроорпНрокрпБродрпНродрпБрогрпНроЯрпБ, роХрпЛро┤ро┐роХрпНроХро▒ро┐, роЪро┐роХрпНроХройрпН, рокрпАро╕рпН, ро▓рпЖроХрпН, ро▓рпЖроХрпНрокрпАро╕рпН, ро╡ро┐ро░рпБроирпНродрпБ
ЁЯНШ	cracker, food, rice, роЕро░ро┐роЪро┐, роЙрогро╡рпБ, роХро┐ро░ро╛роХрпНроХро░рпН, родроЯрпНроЯрпИ, роирпКро▒рпБроХрпНроХрпБродрпНродрпАройро┐, ро░рпИро╕рпН
ЁЯНЩ	ball, food, japanese, rice, роЕро░ро┐роЪро┐, роЙрогро╡роХроорпН, роЙрогро╡рпБ, роЙро░рпБрогрпНроЯрпИ, роЪро╛род, роЬрокрпНрокро╛ройро┐роп, рокроирпНродрпБ
ЁЯНЪ	cooked, food, rice, роЙрогро╡роХроорпН, роЙрогро╡рпБ, роЪро╛родроорпН, роЪрпЛро▒рпБ
ЁЯНЫ	curry, food, rice, роЙрогро╡роХроорпН, роЙрогро╡рпБ, роХрпБро┤роорпНрокрпБ, роХрпБро┤роорпНрокрпБроорпН, роЪро╛родроорпБроорпН, роЪро╛родроорпН, роЪро╛рокрпНрокро╛роЯрпБ, роЪро╛роорпНрокро╛ро░рпБроорпН, роЪрпЛро▒рпБ, роЪрпЛро▒рпБроорпН
ЁЯНЬ	bowl, chopstick, chopsticks, food, noodle, pho, ramen, soup, steaming, роЖро╡ро┐, роЙрогро╡роХроорпН, роЙрогро╡рпБ, роЪрпВрокрпН, роирпВроЯрпВро▓рпНро╕рпН, рокро▒роХрпНроХрпБроорпН, ро░ро╛роорпЖройрпН
ЁЯНЭ	food, meatball, meatballs, pasta, restaurant, spaghetti, роЗродрпНродро╛ро▓ро┐роп, роЙрогро╡роХроорпН, роЙрогро╡рпБ, родроХрпНроХро╛ро│ро┐, роирпВроЯрпВро▓рпНро╕рпН, рокро╛ро▓рпНро╕рпН, роорпАроЯрпН, ро╕рпНрокро╛роХрпЖроЯрпНроЯро┐, ро╕рпНрокрпЖроХроЯрпНроЯро┐
ЁЯНЮ	bread, carb, carbs, food, grain, loaf, restaurant, toast, wheat, роЙрогро╡роХроорпН, роЙрогро╡рпБ, роЪро╛рогрпНроЯрпНро╡ро┐роЪрпН, роЯрпЛро╕рпНроЯрпН, рокро┐ро░рпЖроЯрпН, ро░рпКроЯрпНроЯро┐
ЁЯНЯ	fast, food, french, fries, fry, роГрокро┐ро░рпЖроЮрпНроЪрпБ, роГрокро┐ро░рпЖройрпНроЪрпН, роГрокро┐ро░рпИро╕рпН, роГрокрпНро░рпЖроЮрпНроЪрпБ, роГрокрпНро░рпЖройрпНроЪрпН, роГрокрпНро░рпИро╕рпН, роЙрогро╡роХроорпН, роЙрогро╡рпБ, роЙро░рпБро│рпИ, родрпБро░ро┐род, ро╡ро▒рпБро╡ро▓рпН
ЁЯНа	food, potato, roasted, sweet, роЙрогро╡рпБ, роЙро░рпБро│рпИроХрпНроХро┐ро┤роЩрпНроХрпБ, роХро┐ро┤роЩрпНроХрпБ, роЪро░рпНроХрпНроХро░рпИро╡ро│рпНро│ро┐роХрпН, рокрпКроЯрпНроЯрпЗроЯрпЛ, ро╡ро▒рпБродрпНрод, ро╡ро▒рпБродрпНродродрпБ, ро╕рпНро╡рпАроЯрпН
ЁЯНб	dango, dessert, japanese, skewer, stick, sweet, роЙрогро╡роХроорпН, роЙрогро╡рпБ, роЙро░рпБрогрпНроЯрпИроХро│рпН, роХрпБроЪрпНроЪро┐ропро┐ро▓рпН, роЬрокрпНрокро╛ройро┐роп, роЯрпЗроЩрпНроХрпЛ
ЁЯНв	food, kebab, oden, restaurant, seafood, skewer, stick, роЙрогро╡рпБ, роУроЯрпЗройрпН, роХроЯро▓рпН, роХрокро╛рокрпН, роХрпБроЪрпНроЪро┐, ро╕рпНроХро┐ропрпВро╡ро░рпН
ЁЯНг	food, sushi, роЙрогро╡роХроорпН, роЙрогро╡рпБ, роЪрпБро╖ро┐, роорпАройрпН
ЁЯНд	fried, prawn, shrimp, tempura, роЗро▒ро╛ро▓рпН, роЙрогро╡роХроорпН, роЙрогро╡рпБ, роХроЯро▓рпН, ро╡ро▒рпБродрпНрод
ЁЯНе	cake, fish, food, pastry, restaurant, swirl, роГрокро┐ро╖рпН, роЗройро┐рокрпНрокрпБ, роЙрогро╡роХроорпН, роЙрогро╡рпБ, роХроЯро▓рпН, роХрпЗроХрпН, роЪрпБро░рпБро│рпН, роЯрпЖро╕ро░рпНроЯрпН, ро╡роЯро┐ро╡
ЁЯНж	cream, dessert, food, ice, icecream, restaurant, serve, soft, sweet, роЙрогро╡роХроорпН, роЙрогро╡рпБ, роРро╕рпН, роРро╕рпНроХрпНро░рпАроорпН, роХрпЛройрпН, роЯрпЖро╕ро░рпНроЯрпН
ЁЯНз	dessert, ice, restaurant, shaved, sweet, роЗройро┐рокрпНрокрпБ, роЙрогро╡роХроорпН, роЙрогро╡рпБ, роКро▒рпНро▒ро┐роп, роРро╕рпНроХро┐ро░рпАроорпН, роРро╕рпНроХрпНро░рпАроорпН, роЪро┐ро░рокрпН, роЯрпЖро╕ро░рпНроЯрпН, ро╖рпЗро╡рпНроЯрпН, ро╕рпНроХрпВрокрпН
ЁЯНи	cream, dessert, food, ice, restaurant, sweet, роЙрогро╡роХроорпН, роЙрогро╡рпБ, роРро╕рпНроХро┐ро░рпАроорпН, роРро╕рпНроХрпНро░рпАроорпН, роЯрпЖро╕ро░рпНроЯрпН
ЁЯНй	breakfast, dessert, donut, doughnut, food, sweet, роЗройро┐рокрпНрокрпБ, роЙрогро╡роХроорпН, роЙрогро╡рпБ, роЯрпЖро╕ро░рпНроЯрпН, роЯрпЛройроЯрпН
ЁЯНк	chip, chocolate, cookie, dessert, sweet, роЗройро┐рокрпНрокрпБ, роЙрогро╡роХроорпН, роЙрогро╡рпБ, роХрпБроХрпНроХрпА, роЪро╛роХрпНро▓рпЗроЯрпН, роЪро┐рокрпНро╕рпН, роЯрпЖро╕ро░рпНроЯрпН, ро░рпКроЯрпНроЯро┐
ЁЯНл	bar, candy, chocolate, dessert, halloween, sweet, tooth, роЗройро┐рокрпНрокрпБ, роЙрогро╡роХроорпН, роЙрогро╡рпБ, роЪро╛роХрпНро▓рпЗроЯрпН, рокро╛ро░рпН, рокро┐ро░ро┐ропро░рпН
ЁЯНм	candy, cavities, cavity, dessert, halloween, restaurant, sweet, tooth, wrapper, роЗройро┐рокрпНрокрпБ, роЙрогро╡рпБ, роХрпЗрогрпНроЯро┐, роХрпЗройрпНроЯро┐, рооро┐роЯрпНроЯро╛ропрпН
ЁЯНн	candy, dessert, food, lollipop, restaurant, sweet, роЗройро┐рокрпНрокрпБ, роЙрогро╡рпБ, роХрпБроЪрпНроЪро┐рооро┐роЯрпНроЯро╛ропрпН, рооро┐роЯрпНроЯро╛ропрпН, ро▓ро╛ро▓ро┐рокро╛рокрпН
ЁЯНо	custard, dessert, pudding, sweet, роЗройро┐рокрпНрокрпБ, роЙрогро╡роХроорпН, роЙрогро╡рпБ, роХро╕рпНроЯро░рпНроЯрпБ, роЯрпЖро╕ро░рпНроЯрпН, рокрпБроЯрпНроЯро┐роЩрпН
ЁЯНп	barrel, bear, food, honey, honeypot, jar, pot, sweet, роЗройро┐рокрпНрокрпБ, роЙрогро╡роХроорпН, роЙрогро╡рпБ, роХрпБро╡ро│рпИ, роЬро╛роЯро┐, родрпЗройрпН, рокро╛ройрпИ, рокрпВ, ро╡ро┐ройрпНройро┐, ро╣ройро┐рокро╛роЯрпН
ЁЯН░	cake, dessert, pastry, shortcake, slice, sweet, роЗройро┐рокрпНрокрпБ, роЙрогро╡роХроорпН, роЙрогро╡рпБ, роХрпЗроХрпН, роЯрпЖро╕ро░рпНроЯрпН, родрпБрогрпНроЯрпБ, рокрпАро╕рпН
ЁЯН▒	bento, box, food, роЙрогро╡роХроорпН, роЙрогро╡рпБ, роЯрокрпНрокро╛, рокро╛роХрпНро╕рпН, рокрпЖроЯрпНроЯро┐, рокрпЖройрпНроЯрпЛ
ЁЯН▓	food, of, pot, soup, stew, роЙрогро╡роХроорпН, роЙрогро╡рпБ, роХрпБро┤роорпНрокрпБ, роХрпВроЯрпНроЯрпБ, роЪро╛роорпНрокро╛ро░рпН, роЪрпВроЯро╛рой, роЪрпВрокрпН, роиро┐ро▒рпИроп, рокро╛родрпНродро┐ро░родрпНродро┐ро▓рпН, рокро╛родрпНродро┐ро░роорпН
ЁЯН│	breakfast, cooking, easy, egg, fry, frying, over, pan, restaurant, side, sunny, up, роЙрогро╡рпБ, роХро╛роГрокрпН, роЪроорпИропро▓рпН, рокро╛ропро┐ро▓рпН, роорпБроЯрпНроЯрпИ, ро╣ро╛роГрокрпН
ЁЯН┤	breakfast, breaky, cooking, cutlery, deliciou, delicious, dinner, eat, feed, food, fork, hungry, knife, lunch, restaurant, yum, yummy, роЕро▒рпНрокрпБродроорпН, роЗро░ро╡рпБ, роЙрогро╡роХроорпН, роЙрогро╡рпБ, роХродрпНродро┐, роХродрпНродро┐ропрпБроорпН, роХро╛ро▓рпИ, роирпЗро░роорпН, рокроЪро┐, роородро┐роп, роорпБро│рпНроХро░рогрпНроЯро┐, роорпБро│рпНроХро░рогрпНроЯро┐ропрпБроорпН
ЁЯН╡	beverage, cup, drink, handle, oolong, tea, teacup, роКро▓ро╛роЩрпН, роХрокрпН, роХрпБроЯро┐родрпНродро▓рпН, роХрпИрокрпНрокро┐роЯро┐, родрпЗройрпАро░рпН, родрпЗройрпАро░рпНроХрпНроХрпЛрокрпНрокрпИ, рокро╛ройроорпН
ЁЯН╢	bar, beverage, bottle, cup, drink, restaurant, sake, роЙрогро╡роХроорпН, роХрпЛрокрпНрокрпИропрпБроорпН, роЪрпЗроХрпН, рокро╛роЯрпНроЯро┐ро▓рпБроорпН, рокро╛ройроорпН, рокро╛ро░рпН, роородрпБ, роородрпБрокро╛ройроорпН
ЁЯН╖	alcohol, bar, beverage, booze, club, drink, drinking, drinks, glas, glass, restaurant, wine, роЙрогро╡роХроорпН, роХрпЛрокрпНрокрпИ, рокро╛ройроорпН, роородрпБ, роородрпБроХрпНроХрпЛрокрпНрокрпИ
ЁЯН╕я╕П	alcohol, bar, booze, club, cocktail, drink, drinking, drinks, glas, glass, mad, martini, men, роЙрогро╡роХроорпН, роХро╛роХрпНроЯрпЖропро┐ро▓рпН, роХро┐ро│ро╛ро╕рпН, рокро╛ройроорпН, роородрпБ, роородрпБроХрпНроХро▓ро╡рпИ
ЁЯН╣	alcohol, bar, booze, club, cocktail, drink, drinking, drinks, drunk, mai, party, tai, tropic, tropical, tropics, роЙрогро╡роХроорпН, роЬрпВро╕рпН, рокро┤роЪрпНроЪро╛ро▒рпБ, рокро╛ройроорпН, ро╡ро┐ро░рпБроирпНродрпБ
ЁЯН║	alcohol, ale, bar, beer, booze, drink, drinking, drinks, mug, octoberfest, oktoberfest, pint, stein, summer, роЙрогро╡роХроорпН, роХрпБро╡ро│рпИ, роХрпЛрокрпНрокрпИ, рокро╛ройроорпН, рокрпАро░рпН, ро╡ро┐ро░рпБроирпНродрпБ
ЁЯН╗	alcohol, bar, beer, booze, bottom, bottoms, cheer, cheers, clink, clinking, drink, drinking, drinks, mug, mugs, роЙрогро╡роХроорпН, роХрпБро╡ро│рпИроХро│рпН, роХрпЛрокрпНрокрпИ, рокро╛ройроорпН, рокрпАро░рпН, ро╡ро┐ро░рпБроирпНродрпБ
ЁЯН╝	babies, baby, birth, born, bottle, drink, infant, milk, newborn, роГрокрпАроЯро┐роЩрпН, роХрпБро┤роирпНродрпИ, роЪро┐ро▒рпБрокро┐ро│рпНро│рпИродрпНродройроорпН, рокро╛роЯрпНроЯро┐ро▓рпН, рокро╛ройроорпН, рокро╛ро▓рпН
ЁЯН╛	bar, bottle, cork, drink, popping, роХро╛ро░рпНроХрпН, рокро╛роЯрпНроЯро┐ро▓рпН, рокро╛ройроорпН, рокро╛ро░рпН, рокрпАроЪрпНроЪроЯро┐роХрпНроХрпБроорпН, рокрпАроЪрпНроЪро┐ропроЯро┐, рокрпАроЪрпНроЪро┐ропроЯро┐роХрпНроХрпБроорпН
ЁЯН┐	corn, movie, pop, popcorn, роЙрогро╡рпБ, роХро╛ро░ройрпН, родро┐ро░рпИрокрпНрокроЯроорпН, рокро╛рокрпН, рокро╛рокрпНроХро╛ро░рпНройрпН, рокрпКро░рпБроЯрпНроХро╛роЯрпНроЪро┐
ЁЯОА	celebration, ribbon, роХрпКрогрпНроЯро╛роЯрпНроЯроорпН, родро┐ро▒рокрпНрокрпБ, ро░ро┐рокрпНрокройрпН, ро╡ро┐ро░рпБроирпНродрпБ, ро╡ро┐ро┤ро╛
ЁЯОБ	birthday, bow, box, celebration, christma, christmas, gift, present, surprise, wrapped, роЖроЪрпНроЪро░ро┐роп, роХрпКрогрпНроЯро╛роЯрпНроЯроорпН, роЪро░рпНрокрпНро░рпИро╕рпН, рокро░ро┐роЪрпБ, рокро┐ро▒роирпНродроиро╛ро│рпН, роорпВроЯрокрпНрокроЯрпНроЯ
ЁЯОВ	bday, birthday, cake, celebration, dessert, happy, pastry, sweet, роЗройро┐рокрпНрокрпБ, роЙрогро╡рпБ, роХрпЗроХрпН, роХрпКрогрпНроЯро╛роЯрпНроЯроорпН, рокрогрпНроЯроорпН, рокро┐ро▒роирпНродроиро╛ро│рпН, рокрпЗро╕рпНроЯрпНро░ро┐, рооро╛ро╡рпБрокрпН, ро╡ро╛ро┤рпНродрпНродрпБроХро│рпН, ро╡ро┐ро░рпБроирпНродрпБ
ЁЯОГ	celebration, halloween, jack, lantern, pumpkin, роХрпКрогрпНроЯро╛роЯрпНроЯроорпН, родро┐ро░рпБро╖рпНроЯро┐, рокрпВроЪрогро┐роХрпНроХро╛ропрпН, роорпБроХроорпН, ро╣ро╛ро▓рпЛро╡рпАройрпН, ро╣рпЗро▓рпЛро╡ро┐ройрпН
ЁЯОД	celebration, christma, christmas, tree, роХро╛ро▓роорпН, роХро┐ро▒ро┐ро╕рпНродрпБрооро╕рпН, роХрпКрогрпНроЯро╛роЯрпНроЯроорпН, рокроЪрпБроорпИ, рооро░роорпН
ЁЯОЖ	boom, celebration, entertainment, firework, fireworks, yolo, роТро│ро┐, роХрпКрогрпНроЯро╛роЯрпНроЯроорпН, роЪродрпНродроорпН, родрпАрокро╛ро╡ро│ро┐, рокроЯрпНроЯро╛роЪрпБ, рокрогрпНроЯро┐роХрпИ, ро╡ро╛ройро╡рпЗроЯро┐роХрпНроХрпИ
ЁЯОЗ	boom, celebration, firework, fireworks, sparkle, sparkler, роТро│ро┐, роХрпКрогрпНроЯро╛роЯрпНроЯроорпН, родрпАрокро╛ро╡ро│ро┐, рокрогрпНроЯро┐роХрпИ, роородрпНродро╛рокрпНрокрпБ, ро╡ро╛рой, ро╡рпЗроЯро┐роХрпНроХрпИ
ЁЯОИ	balloon, birthday, celebrate, celebration, роХрпБро┤роирпНродрпИроХро│рпН, роХрпКрогрпНроЯро╛роЯрпНроЯроорпН, родро┐ро░рпБро╡ро┐ро┤ро╛, рокро▓рпВройрпН, рокро┐ро▒роирпНродроиро╛ро│рпН, ро╣рпАро▓ро┐ропроорпН
ЁЯОЙ	awesome, birthday, celebrate, celebration, excited, hooray, party, popper, tada, woohoo, роЕро▒ро┐ро╡ро┐рокрпНрокрпБ, роХрпКрогрпНроЯро╛роЯрпНроЯроорпН, рокро╛рокрпНрокро░рпН, рокро╛ро░рпНроЯрпНроЯро┐, рокро┐ро▒роирпНродроиро╛ро│рпН, ро╡рогрпНрог, ро╡ро┐ро░рпБроирпНродрпБ, ро╡рпЖро▒рпНро▒ро┐, ро╡рпЗроЯро┐роХрпНроХрпИ
ЁЯОК	ball, celebrate, celebration, confetti, party, woohoo, роХро╛роХро┐родроЩрпНроХро│рпИродрпН, роХрпКрогрпНроЯро╛роЯрпНроЯроорпН, родро┐ро░рпБроорогроорпН, родрпВро╡рпБроорпН, рокроирпНродрпБ, рокро╛ро░рпНроЯрпНроЯро┐, рокро┐ро▒роирпНродроиро╛ро│рпН, ро╡рогрпНрогроХрпН, ро╡ро╛ро┤рпНродрпНродрпБроХро│рпН
ЁЯОЛ	banner, celebration, japanese, tanabata, tree, роХрпКрогрпНроЯро╛роЯрпНроЯроорпН, роЬрокрпНрокро╛ройрпН, родройрокродро╛, родро╛ройро╛рокро╛родро╛, родрпЛро░рогроорпН, рооро░роорпН
ЁЯОН	bamboo, celebration, decoration, japanese, pine, plant, роЕро▓роЩрпНроХро╛ро░роорпН, роХрпКрогрпНроЯро╛роЯрпНроЯроорпН, роЬрокрпНрокро╛ройрпН, рокрпБродрпНродро╛рогрпНроЯрпБ, рокрпИройрпН, роорпВроЩрпНроХро┐ро▓рпН
ЁЯОО	celebration, doll, dolls, festival, japanese, роХрпКрогрпНроЯро╛роЯрпНроЯроорпН, роЬрокрпНрокро╛ройро┐роп, роЬрокрпНрокро╛ройрпН, родро┐ро░рпБро╡ро┐ро┤ро╛, рокрпКроорпНроорпИроХро│рпН
ЁЯОП	carp, celebration, streamer, роХрпБро┤роирпНродрпИроХро│рпН, роХрпЖрогрпНроЯрпИ, роХрпКроЯро┐, роХрпКрогрпНроЯро╛роЯрпНроЯроорпН, роЬрокрпНрокро╛ройрпН, родро┐ройроорпН, роиро╛роЯрпНроЯро┐ройрпН, рокро▒роХрпНроХрпБроорпН, роорпАройрпН, ро╡ро┐роЯрпБроорпБро▒рпИ
ЁЯОР	bell, celebration, chime, wind, роУроЪрпИ, роХро╛ро▒рпНро▒ро┐ро▓рпН, роЪро┐роорпН, рокро▒роХрпНроХрпБроорпН, роорогро┐, роорогро┐ропрпЛроЪрпИ
ЁЯОС	celebration, ceremony, moon, viewing, роЕро▒рпБро╡роЯрпИ, роЙрогро╡рпБроХро│рпИ, роХрпКрогрпНроЯро╛роЯрпНроЯроорпН, роиро┐ро▓ро╡ро┐ро▒рпНроХрпБрокрпН, роиро┐ро▓ро╡рпБ, рокроЯрпИродрпНродро▓рпН
ЁЯОТ	backpack, backpacking, bag, bookbag, education, rucksack, satchel, school, роХро▓рпНро╡ро┐, родрпЛро│рпН, рокро│рпНро│ро┐роХрпНроХрпВроЯ, рокро│рпНро│ро┐роХрпНроХрпВроЯроорпН, рокро│рпНро│ро┐рокрпН, рокрпЗроХрпНрокрпЗроХрпН, рокрпИ, рооро╛рогро╡ро░рпНроХро│рпН
ЁЯОУя╕П	cap, celebration, clothing, education, graduation, hat, scholar, роХро▓рпНро▓рпВро░ро┐, роХро▓рпНро╡ро┐, роХрпКрогрпНроЯро╛роЯрпНроЯроорпН, родрпКрокрпНрокро┐, рокроЯрпНроЯродро╛ро░ро┐, рокроЯрпНроЯрооро│ро┐рокрпНрокрпБ, рокроЯрпНроЯрооро│ро┐рокрпНрокрпБродрпН, рокроЯрпНроЯроорпН
ЁЯОа	carousel, entertainment, horse, роЗро░ро╛роЯрпНроЯро┐ройроорпН, роХрпБродро┐ро░рпИ, роХрпЗро░ро╛роЪрпВро▓рпН, роХрпЗро░рпКроЪро▓рпН, рокрпКро┤рпБродрпБрокрпЛроХрпНроХрпБ, ро░ро╛роЯрпНроЯро┐рой, ро░ро╛роЯрпНроЯро┐ройроХрпН, ро░ро╛роЯрпНроЯро┐ройроорпН
ЁЯОб	amusement, ferri, ferris, park, theme, wheel, роГрокрпЖро░рпНро░ро┐ро╕рпН, роЪроХрпНроХро░роорпН, рокрпВроЩрпНроХро╛, рокрпКро░рпБроЯрпНроХро╛роЯрпНроЪро┐, рокрпКро┤рпБродрпБрокрпЛроХрпНроХрпБ, ро░роЩрпНроХ, ро░ро╛роЯрпНроЯро┐ройроорпН
ЁЯОв	amusement, coaster, park, roller, theme, роХрпЛро╕рпНроЯро░рпН, рокрпВроЩрпНроХро╛, рокрпКро┤рпБродрпБрокрпЛроХрпНроХрпБ, рокрпКро┤рпБродрпБрокрпЛроХрпНроХрпБрокрпН, ро░ро╛роЯрпНроЯро┐ройроорпН, ро░рпЛро▓ро░рпН, ро░рпЛро▓ро░рпНроХрпЛро╕рпНроЯро░рпН
ЁЯОг	entertainment, fish, fishing, pole, sport, родрпВрогрпНроЯро┐ро▓рпН, рокро┐роЯро┐родрпНродро▓рпН, рокрпКро┤рпБродрпБрокрпЛроХрпНроХрпБ, роорпАройрпБроорпН, роорпАройрпН, роорпАройрпНродрпВрогрпНроЯро┐ро▓рпБроорпН
ЁЯОд	karaoke, mic, microphone, music, sing, sound, роТро▓ро┐ро╡ро╛роЩрпНроХро┐, роХро░рпЛроХрпНроХро┐, рокро╛роЯрпНроЯрпБ, рокрпЗроЪрпНроЪрпБ, роорпИроХрпН, роорпИроХрпНро░рпЛроГрокрпЛройрпН
ЁЯОе	bollywood, camera, cinema, film, hollywood, movie, record, роХрпЗрооро░ро╛, роХрпЛро▓ро┐ро╡рпБроЯрпН, роЪро┐ройро┐рооро╛, роЪрпЖропрпН, роЯрпЛро▓ро┐ро╡рпБроЯрпН, родро┐ро░рпИрокрпНрокроЯроорпН, рокроЯроорпН, рокродро┐ро╡рпБ, рокро╛ро▓ро┐ро╡рпБроЯрпН, рокрпКро┤рпБродрпБрокрпЛроХрпНроХрпБ, рооро╛ро▓ро┐ро╡рпБроЯрпН, роорпВро╡ро┐, ро╡рпАроЯро┐ропрпЛ, ро╣ро╛ро▓ро┐ро╡рпБроЯрпН
ЁЯОзя╕П	earbud, headphone, sound, роЗроЪрпИ, роЗропро░рпНрокроЯрпН, роТро▓ро┐, роХрпЗроЯрпНроЯро▓рпН, роЪрпЖропрпНродро┐, рокро╛роЯро▓рпН, рокро╛роЯрпНроЯрпБ, рокрпКро┤рпБродрпБрокрпЛроХрпНроХрпБ, ро╣рпЖроЯрпНроГрокрпЛройрпН
ЁЯОи	art, artist, artsy, arty, colorful, creative, entertainment, museum, painter, painting, palette, роЖро░рпНроЯро┐ро╕рпНроЯрпН, роУро╡ро┐ропроорпН, роУро╡ро┐ропро░рпН, роХро▓рпИ, родроЯрпНроЯрпБ, рокрпЗро▓роЯрпН, рокрпКро┤рпБродрпБрокрпЛроХрпНроХрпБ, ро╡рогрпНрогроЩрпНроХро│рпН, ро╡рогрпНрогродрпН
ЁЯОй	clothe, clothes, clothing, fancy, formal, hat, magic, top, tophat, роЖроЯрпИ, роЖрогрпН, роЖрокро┐ро░ро╣ро╛роорпН, роЙроЯрпИ, родрпКрокрпНрокро┐, рокрпЖро░ро┐роп, рокрпКро┤рпБродрпБрокрпЛроХрпНроХрпБ, рооро╛ропро╛роЬро╛ро▓роорпН, роорпЗроЬро┐роХрпН, ро▓ро┐роЩрпНроХройрпН
ЁЯОк	circu, circus, tent, роХрпВроЯро╛ро░роорпН, роЪро░рпНроХрпНроХро╕рпН, рокрпКро┤рпБродрпБрокрпЛроХрпНроХрпБ, роороХро┐ро┤рпНроЪрпНроЪро┐, ро╡ро┐родрпНродрпИ
ЁЯОл	admission, stub, ticket, роЕройрпБроородро┐, роЯро┐роХрпНроХрпЖроЯрпН, роирпБро┤рпИро╡рпБроЪрпНроЪрпАроЯрпНроЯрпБ, рокрпКро┤рпБродрпБрокрпЛроХрпНроХрпБ
ЁЯОмя╕П	action, board, clapper, movie, роХро┐ро│ро╛рокрпН, роХро┐ро│ро╛рокрпНрокро░рпН, роЪро┐ройро┐рооро╛, родро┐ро░рпИрокрпНрокроЯроорпН, рокро▓роХрпИ, рокрпКро░рпБро│рпН, рокрпЛро░рпНроЯрпБ
ЁЯОня╕П	actor, actres, actress, art, arts, entertainment, mask, performing, theater, theatre, thespian, роХро▓рпИ, родро┐ропрпЗроЯрпНроЯро░рпН, родрпЖро░рпБроХрпНроХрпВродрпНродрпБ, роироЯро┐рокрпНрокрпБ, роиро╛роЯроХроорпН, роиро┐роХро┤рпНродрпНродрпБроХро▓рпИ, роорпБроХ, роорпБроХроорпВроЯро┐, роорпБроЯро┐
ЁЯОоя╕П	controller, entertainment, game, video, роОроХрпНро╕рпНрокро╛роХрпНро╕рпН, роХройрпНроЯрпНро░рпЛро▓ро░рпН, роХрпЗроорпН, роЪро╛родройроорпН, рокро┐ро│рпЗ, ро╡ро┐ро│рпИропро╛роЯрпНроЯрпБ, ро╡рпАроЯро┐ропрпЛ, ро╕рпНроЯрпЗро╖ройрпН
ЁЯОп	bull, bullseye, dart, direct, entertainment, game, hit, target, роЕроЯро┐, роЗро▓роХрпНроХрпБ, роОро▒ро┐, роХрпБро▒ро┐, роХрпБро▒ро┐рокро╛ро░рпНродрпНродро▓рпН, роХрпЗроорпН, роЪро░ро┐ропро╛рой, роЯро╛ро░рпНроЯрпН, родрпБро▓рпНро▓ро┐ропрооро╛рой
ЁЯО░	casino, gamble, gambling, game, machine, slot, slots, роЗропроирпНродро┐ро░роорпН, роХрпЗроорпНрокрпНро│ро┐роЩрпН, роЪрпВродро╛роЯрпНроЯроорпН, рооро┐ро╖ро┐ройрпН, ро╡ро┐ро│рпИропро╛роЯрпНроЯрпБ, ро╕рпНро▓ро╛роЯрпН
ЁЯО▒	8ball, ball, billiard, eight, game, pool, роЙро│рпНро│ро░роЩрпНроХ, роОроЯрпНроЯрпБ, рокроирпНродрпБ, рокро┐ро▓рпНро▓ро┐ропро░рпНроЯрпН, рокро┐ро▓рпНро▓ро┐ропро░рпНроЯрпНро╕рпН, ро╡ро┐ро│рпИропро╛роЯрпНроЯрпБ
ЁЯО▓	dice, die, entertainment, game, роЙро░рпБроЯрпНроЯрпБродро▓рпН, роЯрпИро╕рпН, родро╛ропроорпН, рокроХроЯрпИ, рокрпКро┤рпБродрпБрокрпЛроХрпНроХрпБ, ро╡ро┐ро│рпИропро╛роЯрпНроЯрпБ
ЁЯО│	ball, bowling, game, sport, strike, роЪрпЖропрпНродро▓рпН, рокроирпНродрпБ, рокроирпНродрпИ, рокро╡рпБро▓ро┐роЩрпН, рокро╛ро▓рпН, рокрпМро▓ро┐роЩрпН, ро╡ро┐ро│рпИропро╛роЯрпНроЯрпБ
ЁЯО┤	card, cards, flower, game, japanese, playing, роЪрпАроЯрпНроЯрпБ, рокрпВ, ро╡ро┐ро│рпИропро╛роЯрпНроЯрпБ
ЁЯО╡	music, musical, note, sound, роЗроЪрпИ, роЗроЪрпИроХрпН, роХрпАро░рпНродрпНродройрпИ, роХрпБро▒ро┐рокрпНрокрпБ, роЪроЩрпНроХрпАродроорпН, рокро╛роЯро▓рпН, рокро╛роЯрпНроЯрпБ, роорпКро┤ро┐
ЁЯО╢	music, musical, note, notes, sound, роЗроЪрпИ, роЗроЪрпИроХрпН, роТро▓ро┐, роХрпБро▒ро┐рокрпНрокрпБ, роХрпБро▒ро┐рокрпНрокрпБроХро│рпН, рокро╛роЯро▓рпН
ЁЯО╖	instrument, music, sax, saxophone, роЗроЪрпИ, роЗроЪрпИроХрпНроХро░рпБро╡ро┐, роХродрпНро░ро┐, роХро░рпБро╡ро┐, роХро╛ро▒рпНро▒рпБ, роХрпЛрокро╛ро▓рпНроиро╛родрпН, роЪро╛роХрпНро╕рокрпЛройрпН
ЁЯО╕	guitar, instrument, music, strat, роЗроЪрпИ, роЗроЪрпИроХрпНроХро░рпБро╡ро┐, роОро▓роХрпНроЯрпНро░ро┐роХрпН, роХро┐роЯрпНроЯро╛ро░рпН, роХро┐родро╛ро░рпН, роорпЗро▒рпНроХродрпНродро┐роп, ро╡рпЖро╕рпНроЯро░рпНройрпН
ЁЯО╣	instrument, keyboard, music, musical, piano, роЗроЪрпИ, роЗроЪрпИроХрпНроХро░рпБро╡ро┐, роХрпАрокрпЛро░рпНроЯрпБ, роХрпАрокрпЛро░рпНроЯрпН, рокро╛роЯро▓рпН, рокро┐ропро╛ройрпЛ, рооро┐ропрпВроЪро┐роХрпН
ЁЯО║	instrument, music, trumpet, роЗроЪрпИ, роЗроЪрпИроХрпНроХро░рпБро╡ро┐, роКродрпБроХрпКроорпНрокрпБ, роХро░рпБро╡ро┐, роЯро┐ро░роорпНрокроЯрпН
ЁЯО╗	instrument, music, violin, роЗроЪрпИ, роЗроЪрпИроХрпНроХро░рпБро╡ро┐, роХро░рпБро╡ро┐, роХро░рпНроиро╛роЯроХ, роЪроЩрпНроХрпАродроорпН, родроирпНродро┐, рокроХрпНроХ, ро╡ропро▓ро┐ройрпН, ро╡ро╛родрпНродро┐ропроорпН, ро╡ро┐ро▓рпН
ЁЯО╝	music, musical, note, score, роЗроЪрпИ, роЗроЪрпИроХрпН, роХрпБро▒ро┐рокрпНрокрпБ, роХрпЛро░рпНрокрпНрокрпБ, роирпЛроЯрпНроЯрпБ, рокро╛роЯро▓рпН, рооро┐ропрпВро╕ро┐роХро▓рпН, ро╕рпНроХрпЛро░рпН
ЁЯО╜	athletic, athletics, running, sash, shirt, роЕродрпНро▓рпЖроЯро┐роХрпНро╕рпН, роЖроЯрпИ, роУроЯрпНроЯрокрпНрокроирпНродропроЪрпН, роЪроЯрпНроЯрпИ, родроЯроХро│роорпН, ро░ройрпНройро┐роЩрпН, ро╡ро┐ро│рпИропро╛роЯрпНроЯрпБ, ро╡рпАро░ро░рпБроХрпНроХро╛рой
ЁЯО╛	ball, racquet, sport, tenni, tennis, роЯрпЖройрпНройро┐ро╕рпН, рокроирпНродрпБ, рокро╛ро▓рпН, роороЯрпНроЯрпИ, ро╡ро┐ро│рпИропро╛роЯрпНроЯрпБ
ЁЯО┐	ski, skis, snow, sport, рокройро┐, рокройро┐роЪрпНроЪро▒рпБроХрпНроХрпБ, рокро▓роХрпИ, ро╡ро┐ро│рпИропро╛роЯрпНроЯрпБ, ро╕рпНроХрпА
ЁЯПА	ball, basketball, hoop, sport, роХрпВроЯрпИрокрпНрокроирпНродрпБ, рокро╛ро▓рпН, рокро╛ро╕рпНроХрпЖроЯрпН, рокрпЗро╕рпНроХроЯрпН, ро╡ро┐ро│рпИропро╛роЯрпНроЯрпБ
ЁЯПВя╕П	ski, snow, snowboard, snowboarder, sport, роирокро░рпН, рокройро┐роЪрпНроЪро▒рпБроХрпНроХрпБ, ро╡ро┐ро│рпИропро╛роЯрпНроЯрпБ, ро╡рпАро░ро░рпН, ро╕рпНроХрпА, ро╕рпНроХрпАропро┐роЩрпН, ро╕рпНройрпЛрокрпЛро░рпНроЯро░рпН, ро╕рпНройрпЛрокрпЛро░рпНроЯро┐роЩрпН
ЁЯПГ	fast, hurry, marathon, move, person, quick, race, racing, run, running, rush, speed, роЖрогрпН, роУроЯрпНроЯрокрпНрокроирпНродропроорпН, роУроЯрпНроЯроорпН, роирокро░рпН, рокро░рокро░рокрпНрокрпБ, рооро╛ро░родрпНродро╛ройрпН, ро╡ро░рпБроХро┐ро▒рпЗройрпН, ро╡ро┐ро│рпИропро╛роЯрпНроЯрпБ, ро╡рпЗроХроорпН
ЁЯПГтАНтЩАя╕П	fast, hurry, marathon, move, quick, race, racing, run, running, rush, speed, woman, роУроЯрпБродро▓рпН, роУроЯрпБроорпН, роУроЯрпНроЯроорпН, роирокро░рпН, рокрпЖрогрпН, рооро╛ро░родрпНродро╛ройрпН, ро╡ро░рпБроХро┐ро▒рпЗройрпН, ро╡ро┐ро░рпИро╡рпБ
ЁЯПГтАНтЩАя╕ПтАНтЮбя╕П	facing, fast, hurry, marathon, move, quick, race, racing, right, run, running, rush, speed, woman
ЁЯПГтАНтЩВя╕П	fast, hurry, man, marathon, move, quick, race, racing, run, running, rush, speed, роЖрогрпН, роУроЯрпБроорпН, роУроЯрпНроЯроорпН
ЁЯПГтАНтЩВя╕ПтАНтЮбя╕П	facing, fast, hurry, man, marathon, move, quick, race, racing, right, run, running, rush, speed
ЁЯПГтАНтЮбя╕П	facing, fast, hurry, marathon, move, person, quick, race, racing, right, run, running, rush, speed
ЁЯПДя╕П	beach, ocean, person, sport, surf, surfer, surfing, swell, wave, waves, роЕро▓рпИ, роЖрогрпН, роХроЯро▓рпН, роЪро░рпНроГрокро░рпН, роЪро░рпНроГрокро┐роЩрпН, роЪро░рпНрокро┐роЩрпН, роЪрпЖропрпНрокро╡ро░рпН, роирокро░рпН, роирпАро░рпН, ро╡ро┐ро│рпИропро╛роЯрпНроЯрпБ
ЁЯПДтАНтЩАя╕П	beach, ocean, person, sport, surf, surfer, surfing, swell, wave, waves, woman, роЕро▓рпИ, роЕро▓рпИроЪрпНроЪро▒рпБроХрпНроХрпБ, роХроЯро▓рпН, роЪро░рпНроГрокро░рпН, роЪро░рпНроГрокро┐роЩрпН, роирокро░рпН, рокрпЖрогрпН, ро╡ро┐ро│рпИропро╛роЯрпБроорпН, ро╡ро┐ро│рпИропро╛роЯрпНроЯрпБ
ЁЯПДтАНтЩВя╕П	beach, man, ocean, sport, surf, surfer, surfing, swell, wave, waves, роЕро▓рпИроЪрпНроЪро▒рпБроХрпНроХрпБ, роЖрогрпН, роЪро░рпНроГрокро┐роЩрпН, ро╡ро┐ро│рпИропро╛роЯрпБроорпН, ро╡ро┐ро│рпИропро╛роЯрпНроЯрпБ
ЁЯПЕ	award, gold, medal, sport, sports, winner, родроЩрпНроХ, родроЩрпНроХрокрпНрокродроХрпНроХроорпН, рокродроХрпНроХроорпН, роорпЖроЯро▓рпН, ро╡ро┐ро░рпБродрпБ, ро╡ро┐ро│рпИропро╛роЯрпНроЯрпБрокрпН, ро╡рпЖро▒рпНро▒ро┐ропро╛ро│ро░рпН
ЁЯПЖя╕П	champ, champion, champs, prize, slay, sport, trophy, victory, win, winning, роХрпЛрокрпНрокрпИ, роЪро╛роорпНрокро┐ропройрпН, роЯро┐ро░ро╛рокро┐, роЯро┐ро░рпЛрокро┐, рокро░ро┐роЪрпБ, ро╡рпЖро▒рпНро▒ро┐, ро╡рпЖро▒рпНро▒ро┐роХрпН
ЁЯПЗ	horse, jockey, racehorse, racing, riding, sport, роХрпБродро┐ро░рпИ, роХрпБродро┐ро░рпИрокрпН, роХрпБродро┐ро░рпИрокрпНрокроирпНродропроорпН, роЪрпВродро╛роЯрпНроЯроорпН, роЬро╛роХрпНроХро┐, роирокро░рпН, рокроирпНродропроорпН, рокроирпНродрпИропроорпН, ро░рпЗро╕рпНроХрпБродро┐ро░рпИ, ро╡ро┐ро│рпИропро╛роЯрпНроЯрпБ
ЁЯПИ	american, ball, bowl, football, sport, super, роЕроорпЖро░ро┐роХрпНроХ, роХро╛ро▓рпНрокроирпНродрпБ, роЪрпВрокрпНрокро░рпН, рокроирпНродрпБ, рокро╡рпБро▓рпН, ро╡ро┐ро│рпИропро╛роЯрпНроЯрпБ
ЁЯПЙ	ball, football, rugby, sport, роХро╛ро▓рпНрокроирпНродрпБ, ро░роХрпНрокро┐, ро╡ро┐ро│рпИропро╛роЯрпНроЯрпБ
ЁЯПКя╕П	freestyle, person, sport, swim, swimmer, swimming, triathlon, роирокро░рпН, роирпАроЪрпНроЪро▓рпН, роирпАроирпНродрпБродро▓рпН, роирпАроирпНродрпБрокро╡ро░рпН, роирпАроирпНродрпБроорпН, ро╡ро┐ро│рпИропро╛роЯрпНроЯрпБ, ро╡рпАро░ро░рпН
ЁЯПКтАНтЩАя╕П	freestyle, man, sport, swim, swimmer, swimming, triathlon, woman, роХрпБро│роорпН, роХрпБро│ро┐ропро▓рпН, роирокро░рпН, роирпАроЪрпНроЪро▓рпН, роирпАроирпНродрпБродро▓рпН, роирпАроирпНродрпБроорпН, рокрпЖрогрпН, ро╡ро┐ро│рпИропро╛роЯрпНроЯрпБ
ЁЯПКтАНтЩВя╕П	freestyle, man, sport, swim, swimmer, swimming, triathlon, роЖрогрпН, роирпАроЪрпНроЪро▓рпН, роирпАроирпНродрпБроорпН, ро╡ро┐ро│рпИропро╛роЯрпНроЯрпБ
ЁЯПЛя╕ПтАНтЩАя╕П	barbell, bodybuilder, deadlift, lifter, lifting, powerlifting, weight, weightlifter, weights, woman, workout, роОроЯрпИ, родрпВроХрпНроХрпБродро▓рпН, роирокро░рпН, рокро│рпБродрпВроХрпНроХрпБродро▓рпН, рокро│рпБродрпВроХрпНроХрпБроорпН, рокрпЖрогрпН, ро▓ро┐роГрокрпНроЯро┐роЩрпН, ро╡ро┐ро│рпИропро╛роЯрпНроЯрпБ, ро╡рпЖропро┐роЯрпН
ЁЯПЛя╕ПтАНтЩВя╕П	barbell, bodybuilder, deadlift, lifter, lifting, man, powerlifting, weight, weightlifter, weights, workout, роЖрогрпН, рокро│рпБродрпВроХрпНроХрпБродро▓рпН, рокро│рпБродрпВроХрпНроХрпБроорпН, ро╡ро┐ро│рпИропро╛роЯрпНроЯрпБ
ЁЯПМя╕ПтАНтЩАя╕П	ball, birdie, caddy, driving, golf, golfing, green, pga, putt, range, tee, woman, роХрпЛро▓рпНроГрокрпН, роирокро░рпН, рокроирпНродрпБ, рокрпЖрогрпН, роорпИродро╛ройроорпН, ро╡ро┐ро│рпИропро╛роЯрпБроорпН, ро╡ро┐ро│рпИропро╛роЯрпНроЯрпБ
ЁЯПМя╕ПтАНтЩВя╕П	ball, birdie, caddy, driving, golf, golfing, green, man, pga, putt, range, tee, роЖрогрпН, роХрпЛро▓рпНроГрокрпН, ро╡ро┐ро│рпИропро╛роЯрпБроорпН, ро╡ро┐ро│рпИропро╛роЯрпНроЯрпБ
ЁЯПП	ball, bat, cricket, game, роХро┐ро░ро┐роХрпНроХрпЖроЯрпН, рокроирпНродрпБ, роороЯрпНроЯрпИ, ро╡ро┐ро│рпИропро╛роЯрпНроЯрпБ
ЁЯПР	ball, game, volleyball, роХрпИрокрпНрокроирпНродрпБ, рокроирпНродрпБ, рокро╛ро▓рпН, ро╡ро╛ро▓ро┐рокро╛ро▓рпН, ро╡ро┐ро│рпИропро╛роЯрпНроЯрпБ
ЁЯПС	ball, field, game, hockey, stick, роГрокрпАро▓рпНроЯрпБ, роЗроирпНродро┐роп, родройрпНро░ро╛роЬрпН, родрпЗроЪро┐роп, рокроирпНродрпБ, ро╡ро┐ро│рпИропро╛роЯрпНроЯрпБ, ро╣ро╛роХрпНроХро┐
ЁЯПТ	game, hockey, ice, puck, stick, роороЯрпНроЯрпИ, ро╡ро┐ро│рпИропро╛роЯрпНроЯрпБ, ро╣ро╛роХрпНроХро┐
ЁЯПУ	ball, bat, game, paddle, ping, pingpong, pong, table, tenni, tennis, роЯрпЖройрпНройро┐ро╕рпН, роЯрпЗрокро┐ро│рпН, рокроирпНродрпБ, рокро╛роЩрпНроХрпН, рокро┐роЩрпНроХрпН, роорпЗроЪрпИрокрпНрокроирпНродро╛роЯрпНроЯроорпН, ро╡ро┐ро│рпИропро╛роЯрпНроЯрпБ
ЁЯПая╕П	building, country, heart, home, house, ranch, settle, simple, suburban, suburbia, where, роЗро▓рпНро▓роорпН, роХроЯрпНроЯро┐роЯроорпН, ро╡рпАроЯрпБ
ЁЯПб	building, country, garden, heart, home, house, ranch, settle, simple, suburban, suburbia, where, роЗро░рпБроХрпНроХрпБроорпН, роХроЯрпНроЯро┐роЯроорпН, родрпЛроЯрпНроЯродрпНродрпБроЯройрпН, родрпЛроЯрпНроЯроорпН, ро╡рпАроЯрпБ, ро╡рпАроЯрпНроЯрпБродрпН
ЁЯПв	building, city, cubical, job, office, роЕро▓рпБро╡ро▓роХроХрпН, роЕро▓рпБро╡ро▓роХроорпН, роЖрокро┐ро╕рпН, роХроЯрпНроЯро┐роЯроорпН
ЁЯПг	building, japanese, office, post, роЕроЮрпНроЪро▓рпН, роЕро▓рпБро╡ро▓роХроорпН, роЖрокро┐ро╕рпН, роХроЯрпНроЯро┐роЯроорпН, роЬрокрпНрокро╛ройрпН, роиро╛роЯрпНроЯро┐ройрпН, рокрпЛро╕рпНроЯрпН
ЁЯПд	building, european, office, post, роЕроЮрпНроЪро▓рпН, роЕро▓рпБро╡ро▓роХроорпН, роЖрокро┐ро╕рпН, роХроЯрпНроЯро┐роЯроорпН, родрокро╛ро▓рпН, рокрпЛро╕рпНроЯрпН
ЁЯПе	building, doctor, hospital, medicine, роХроЯрпНроЯро┐роЯроорпН, роХро┐ро│ро┐ройро┐роХрпН, рооро░рпБродрпНродрпБро╡рооройрпИ, рооро░рпБродрпНродрпБро╡ро░рпН, ро╣ро╛ро╕рпНрокро┐роЯрпНроЯро▓рпН
ЁЯПж	bank, building, роХроЯрпНроЯро┐роЯроорпН, рокрпЗроЩрпНроХрпН, ро╡роЩрпНроХро┐
ЁЯПи	building, hotel, роХроЯрпНроЯро┐роЯроорпН, родроЩрпНроХрпБрооро┐роЯроорпН, ро╡ро┐роЯрпБродро┐, ро╣рпЛроЯрпНроЯро▓рпН
ЁЯПй	building, hotel, love, роХроЯрпНроЯро┐роЯроорпН, ро▓ро╡рпН, ро╣рпЛроЯрпНроЯро▓рпН
ЁЯПк	24, building, convenience, hour, hours, store, роХроЯрпНроЯро┐роЯроорпН, роЪро┐ро▒ро┐роп, роЪрпВрокрпНрокро░рпН, рооро│ро┐роХрпИ, рооро│ро┐роХрпИроХрпНроХроЯрпИ, рооро╛ро░рпНроХрпНроХрпЖроЯрпН, ро╕рпНроЯрпЛро░рпН
ЁЯПл	building, school, роХроЯрпНроЯро┐роЯроорпН, роХро▓рпНро╡ро┐роХрпНроХрпВроЯроорпН, роЪро╛ро▓рпИ, рокро│рпНро│ро┐, рокро│рпНро│ро┐роХрпН, рокро│рпНро│ро┐роХрпНроХрпВроЯроорпН, рокро╛роЯ
ЁЯПм	building, department, store, роХроЯрпНроЯро┐роЯроорпН, роЪрпВрокрпНрокро░рпН, роЯро┐рооро╛ро░рпНроЯрпНроорпЖройрпНроЯро▓рпН, рокрпКро░рпБроЯрпНроХро│рпН, рооро│ро┐роХрпИ, рооро│ро┐роХрпИроХрпНроХроЯрпИ, рооро╛ро░рпНроХрпНроХрпЖроЯрпН, ро╕рпНроЯрпЛро░рпН
ЁЯПня╕П	building, factory, роЖро▓рпИ, роХроЯрпНроЯро┐роЯроорпН, родрпКро┤ро┐ро▒рпНроЪро╛ро▓рпИ, родрпКро┤ро┐ро▓роХроорпН
ЁЯПо	bar, lantern, light, paper, red, restaurant, роТро│ро┐, роХро╛роХро┐род, роЪро┐роХрокрпНрокрпБ, роЪро┐ро╡рокрпНрокрпБ, роЬрокрпНрокро╛ройро┐роп, роиро┐ро▒, рокро╛ро░рпН, рокрпКро░рпБро│рпН, ро░рпЖро╕рпНроЯро╛ро░ройрпНроЯрпН, ро╡ро┐ро│роХрпНроХрпБ
ЁЯПп	building, castle, japanese, роЕро░рогрпНрооройрпИ, роХроЯрпНроЯро┐роЯроорпН, роХрпЗро╕ро┐ро▓рпН, роХрпЛроЯрпНроЯрпИ, роЬрокрпНрокро╛ройрпН, рокро╛рогро┐
ЁЯП░	building, castle, european, роЕро░рогрпНрооройрпИ, роРро░рпЛрокрпНрокро┐роп, роХроЯрпНроЯро┐роЯроорпН, роХрпЗро╕ро┐ро▓рпН, роХрпЛроЯрпНроЯрпИ, рокро╛рогро┐
ЁЯП╕	badminton, birdie, game, racquet, shuttlecock, роХрпЗроорпН, рокрпВрокрпНрокроирпНродро╛роЯрпНроЯроорпН, рокрпВрокрпНрокроирпНродрпБ, рокрпЗроЯрпНрооро┐рогрпНроЯройрпН, ро╡ро┐ро│рпИропро╛роЯрпНроЯрпБ, ро╖роЯрпНроЯро┐ро▓рпНроХро╛роХрпН
ЁЯП╣	archer, archery, arrow, bow, sagittariu, sagittarius, tool, weapon, zodiac, роЕроорпНрокрпБ, роЕроорпНрокрпБроорпН, роЖропрпБродроорпН, родройрпБроЪрпБ, ропрпБродрпНродроорпН, ро░ро╛роЪро┐, ро░ро╛рооройрпН, ро░ро╛рооро░рпН, ро╡ро┐ро▓рпН, ро╡ро┐ро▓рпНро▓рпБроорпН, ро╡ро┐ро▓рпНро╡ро┐родрпНродрпИ
ЁЯП║	amphora, aquariu, aquarius, cooking, drink, jug, tool, weapon, zodiac, роЕро▓роЩрпНроХро╛ро░, роЙрогро╡рпБ, роХрпБроорпНрок, роХрпБроорпНрокроорпН, роЬро╛роЯро┐, рокро╛ройроорпН, рокрпКро░рпБро│рпН, ро░ро╛роЪро┐, ро╡рпАроЯрпНроЯрпБ
ЁЯРА	animal, rat, роОро▓ро┐, роЬрпЖро░рпНро░ро┐, ро╡ро┐ро▓роЩрпНроХрпБ
ЁЯРБ	animal, animals, mouse, роОро▓ро┐, роЪрпБрогрпНроЯрпЖро▓ро┐, ро╡ро┐ро▓роЩрпНроХрпБ
ЁЯРВ	animal, animals, bull, farm, ox, tauru, taurus, zodiac, роОро░рпБродрпБ, роХро╛ро│рпИ, ро░ро╛роЪро┐, ро╡ро┐ро▓роЩрпНроХрпБ
ЁЯРГ	animal, buffalo, water, zoo, роОро░рпБроорпИ, роирпАро░рпН, рооро┐ро░рпБроХроорпН, ро╡ро┐ро▓роЩрпНроХрпБ
ЁЯРД	animal, animals, cow, farm, milk, moo, рокроЪрпБ, рокроЪрпБрооро╛роЯрпБ, рокрогрпНрогрпИ, рокро╛ро▓рпН, ро╡ро┐ро▓роЩрпНроХрпБ
ЁЯРЕ	animal, big, cat, predator, tiger, zoo, роЪро░рогро╛ро▓ропроорпН, родрпЗроЪро┐роп, рокрпБро▓ро┐, рооро┐ро░рпБроХроорпН, ро╡ройро╡ро┐ро▓роЩрпНроХрпБ, ро╡ро┐ро▓роЩрпНроХрпБ
ЁЯРЖ	animal, big, cat, leopard, predator, zoo, роХро╛роЯрпБ, роЪро░рогро╛ро▓ропроорпН, роЪро┐ро▒рпБродрпНродрпИ, роЪро┐ро▒рпБродрпНродрпИрокрпНрокрпБро▓ро┐, рооро┐ро░рпБроХроорпН, ро╡ройро╡ро┐ро▓роЩрпНроХрпБ, ро╡ро┐ро▓роЩрпНроХрпБ
ЁЯРЗ	animal, bunny, pet, rabbit, роХрпБроЯрпНроЯро┐, роЪрпЖро▓рпНро▓рокрпНрокро┐ро░ро╛рогро┐, роорпБропро▓рпН, роорпКроЪроХрпН, ро░рпЗрокро┐роЯрпН, ро╡ро┐ро▓роЩрпНроХрпБ
ЁЯРИя╕П	animal, animals, cat, cats, kitten, pet, роЪрпЖро▓рпНро▓рокрпНрокро┐ро░ро╛рогро┐, рокрпВройрпИ, рокрпВройрпИроХрпНроХрпБроЯрпНроЯро┐, ро╡ро┐ро▓роЩрпНроХрпБ
ЁЯРИтАНтмЫ	animal, black, cat, feline, halloween, meow, unlucky, роХро░рпБрокрпНрокрпБ, роХро░рпБрокрпНрокрпБрокрпН, родрпБро░родро┐ро░рпНро╖рпНроЯроорпН, рокрпВройрпИ, ро╡ро┐ро▓роЩрпНроХрпБ
ЁЯРЙ	animal, dragon, fairy, fairytale, knight, knights, tale, роЖроГрокрпН, роХрпЗроорпН, роЪрпАрой, роЪрпАройро╛, роЯро┐ро░ро╛роХройрпН, родрпНро░рпЛройрпНро╕рпН, роиро╛роХроорпН, рокро▒роХрпНроХрпБроорпН, рооро┐ро░рпБроХроорпН, ро╡ро┐ро▓роЩрпНроХрпБ
ЁЯРК	animal, crocodile, zoo, роКро░рпНро╡родрпБ, роЪро░рогро╛ро▓ропроорпН, роорпБродро▓рпИ, ро╡ройро╡ро┐ро▓роЩрпНроХрпБ, ро╡ро┐ро▓роЩрпНроХрпБ
ЁЯРЛ	animal, beach, ocean, whale, роЙропро┐ро░ро┐, роЪрпБро▒ро╛, родро┐рооро┐роЩрпНроХро▓роорпН, роирпАро░рпНро╡ро╛ро┤рпН, рокро╛ро▓рпВроЯрпНроЯро┐, ро╡ро┐ро▓роЩрпНроХрпБ
ЁЯРМ	animal, escargot, garden, nature, slug, snail, роиродрпНродрпИ, ро╡ро┐ро▓роЩрпНроХрпБ
ЁЯРН	animal, bearer, ophiuchu, ophiuchus, serpent, snake, zodiac, роиро╛роХроорпН, рокро╛роорпНрокрпБ, ро╡ро┐ро▓роЩрпНроХрпБ
ЁЯРО	animal, equestrian, farm, horse, racehorse, racing, роУроЯрпБроорпН, роХрпБродро┐ро░рпИ, рокроирпНродроп, рокроирпНродропроорпН, ро░рпЗро╕рпНроХрпЛро░рпНро╕рпН, ро╡ро┐ро▓роЩрпНроХрпБ
ЁЯРП	animal, aries, ary, horn, horns, male, ram, sheep, zodiac, zoo, роЖроЯрпБ, роЖроЯрпНроЯрпБроХрпНроХроЯро╛, роЗро░ро╛роЪро┐, роХро┐роЯро╛, роХрпКроорпНрокрпБ, роЪрпЖроорпНрооро▒ро┐, роорпЗро╖роорпН, ро░ро╛роЪро┐, ро╡ро┐ро▓роЩрпНроХрпБ
ЁЯРР	animal, capricorn, farm, goat, milk, zodiac, роЖроЯрпБ, роЗро░ро╛роЪро┐, роороХро░роорпН, ро░ро╛роЪро┐, ро╡ро┐ро▓роЩрпНроХрпБ, ро╡рпЖро│рпНро│ро╛роЯрпБ
ЁЯРС	animal, baa, ewe, farm, female, fluffy, lamb, sheep, wool, роЖроЯрпБ, роХроорпНрокро│ро┐, роЪрпЖроорпНрооро▒ро┐, рокрогрпНрогрпИ, ро╡ро┐ро▓роЩрпНроХрпБ
ЁЯРТ	animal, banana, monkey, роХрпБро░роЩрпНроХрпБ, роХрпЛродро┐, роороЩрпНроХро┐, ро╡ро╛ройро░роорпН, ро╡ро┐ро▓роЩрпНроХрпБ
ЁЯРУ	animal, bird, ornithology, rooster, роХрпВро╡рпБродро▓рпН, роХрпКроХрпНроХро░роХрпНроХрпЛ, роЪрпЗро╡ро▓рпН, рокро▒ро╡рпИ, ро╡рпАроЯрпНроЯрпБроЪрпН
ЁЯРФ	animal, bird, chicken, ornithology, роХрпБроЮрпНроЪрпБ, роХрпЛро┤ро┐роХрпНроХрпБроЮрпНроЪрпБ, роЪро┐роХрпНроХройрпН, рокро▒ро╡рпИ
ЁЯРХя╕П	animal, animals, dog, dogs, pet, роЪрпЖро▓рпНро▓рокрпНрокро┐ро░ро╛рогро┐, роиро╛ропрпН, роиро╛ропрпНроХрпНроХрпБроЯрпНроЯро┐, ро╡ро┐ро▓роЩрпНроХрпБ
ЁЯРХтАНЁЯж║	accessibility, animal, assistance, dog, service, роЙродро╡ро┐, роЪрпЖро▓рпНро▓рпБродро▓рпН, роЪрпЗро╡рпИ, роЪрпЗро╡рпИрокрпБро░ро┐ропрпБроорпН, роиро╛ропрпН, ро╡ро┐ро▓роЩрпНроХрпБ
ЁЯРЦ	animal, bacon, farm, pig, pork, sow, рокрогрпНрогрпИ, рокройрпНройро┐, рокройрпНро▒ро┐, рокройрпНро▒ро┐роХрпНроХрпБроЯрпНроЯро┐, рокрпЛро░рпНроХрпН, ро╡ро┐ро▓роЩрпНроХрпБ, ро╡рпЖро│рпНро│рпИ
ЁЯРЧ	animal, boar, pig, роЕро╡родро╛ро░роорпН, роЖрогрпНрокройрпНро▒ро┐, рокройрпНройро┐, рокройрпНро▒ро┐, ро╡ро░ро╛роХ, ро╡ро░ро╛роХроорпН, ро╡ро┐ро▓роЩрпНроХрпБ
ЁЯРШ	animal, elephant, роХрпБроЯрпНроЯро┐, роЪро░рогро╛ро▓ропроорпН, ропро╛ройрпИ, ропро╛ройрпИроХрпБроЯрпНроЯро┐, ро╡ро┐ро▓роЩрпНроХрпБ
ЁЯРЩ	animal, creature, ocean, octopu, octopus, роЖроХрпНроЯрпЛрокро╕рпН, роХроЯро▓рпН, рокрпЗропрпНроХрпНроХрогро╡ро╛ропрпН, ро╡ро┐ро▓роЩрпНроХрпБ
ЁЯРЪ	animal, beach, conch, sea, shell, spiral, роХроЯро▒рпНроХро░рпИ, роХроЯро▓рпН, роХро┐ро│ро┐роЮрпНроЪро▓рпН, роЪроЩрпНроХрпБ, роЪро┐рокрпНрокро┐, роорпБродрпНродрпБ, ро╡ро┐ро▓роЩрпНроХрпБ
ЁЯРЫ	animal, bug, garden, insect, роХроорпНрокро│ро┐рокрпНрокрпБро┤рпБ, рокрпБро┤рпБ, рокрпВроЪрпНроЪро┐, рокрпВро░ро╛ройрпН, роорпВроЯрпНроЯрпИрокрпН, ро╡ро┐ро▓роЩрпНроХрпБ
ЁЯРЬ	animal, ant, garden, insect, роЗройро┐рокрпНрокрпБ, роОро▒рпБроорпНрокрпБ, роХроЯро┐, рокрпВроЪрпНроЪро┐, ро╡ро┐ро▓роЩрпНроХро┐ройроорпН
ЁЯРЭ	animal, bee, bumblebee, honey, honeybee, insect, nature, spring, роХрпВроЯрпБ, родрпЗройрпА, родрпЗройрпН, рокрпВроЪрпНроЪро┐, ро░рпАроЩрпНроХро╛ро░роорпН, ро╡ро┐ро▓роЩрпНроХро┐ройроорпН
ЁЯРЮ	animal, beetle, garden, insect, lady, ladybird, ladybug, nature, роХрпБро│ро╡ро┐, рокроХрпН, рокрпВроЪрпНроЪро┐, рокрпЖрогрпН, ро▓рпЗроЯро┐, ро╡рогрпНроЯрпБ, ро╡ро┐ро▓роЩрпНроХро┐ройроорпН
ЁЯРЯя╕П	animal, dinner, fish, fishe, fishes, fishing, pisce, pisces, zodiac, роЙропро┐ро░ро┐ройроорпН, роирпАро░рпНро╡ро╛ро┤рпН, роорпАройроорпН, роорпАройрпН, ро╡ро┐ро▓роЩрпНроХро┐ройроорпН
ЁЯРа	animal, fish, fishe, fishes, tropical, роЙропро┐ро░ро┐ройроорпН, роиройрпНройрпАро░рпН, роирпАро░рпНро╡ро╛ро┤рпН, роорпАройрпН, ро╡ро┐ро▓роЩрпНроХро┐ройроорпН, ро╡рпЖрокрпНрокроорогрпНроЯро▓
ЁЯРб	animal, blowfish, fish, роГрокро┐ро╖рпН, роЙропро┐ро░ро┐ройроорпН, роКродро┐рокрпНрокрпЖро░рпБроХрпНроХроороЯрпИропрпБроорпН, роХрпБро│рпЛрокрпН, роирпАро░рпНро╡ро╛ро┤рпН, рокрпНро│рпЛ, роорпАройрпН, ро╡ро┐ро▓роЩрпНроХро┐ройроорпН
ЁЯРв	animal, terrapin, tortoise, turtle, роЖроорпИ, роКро░рпНро╡рой, роХроЯро▓ро╛роорпИ, ро╡ро┐ро▓роЩрпНроХро┐ройроорпН
ЁЯРг	animal, baby, bird, chick, egg, hatching, роХрпБроЮрпНроЪрпБ, роХрпЛро┤ро┐роХрпНроХрпБроЮрпНроЪрпБ, рокро▒ро╡рпИ, рокрпКро▒ро┐родрпНродро▓рпН, роорпБроЯрпНроЯрпИропро┐ро▓ро┐ро░рпБроирпНродрпБ, ро╡рпЖро│ро┐ро╡ро░рпБроорпН
ЁЯРд	animal, baby, bird, chick, ornithology, роХрпБроЮрпНроЪрпБ, роХрпЛро┤ро┐, роХрпЛро┤ро┐роХрпНроХрпБроЮрпНроЪрпБ, роЪро┐роХрпНроХройрпН, ро╡ро┐ро▓роЩрпНроХро┐ройроорпН
ЁЯРе	animal, baby, bird, chick, facing, front, newborn, ornithology, роХрпБроЮрпНроЪрпБ, роХрпЛро┤ро┐, роХрпЛро┤ро┐роХрпНроХрпБроЮрпНроЪрпБ, роЪро┐роХрпНроХройрпН, роирпЗро░рпБроХрпНроХрпБ, роирпЗро░рпН, рокро▒ро╡рпИ, рокро╛ро░рпНроХрпНроХрпБроорпН, роорпБройрпНроиро┐ройрпНро▒рпБ, ро╡ро┐ро▓роЩрпНроХро┐ройроорпН
ЁЯРжя╕П	animal, bird, ornithology, рокро▒ро╡рпИ, роорпВроХрпНроХрпБ, ро╡ро┐ро▓роЩрпНроХро┐ройроорпН
ЁЯРжтАНтмЫ	animal, beak, bird, black, caw, corvid, crow, ornithology, raven, rook, роЕрогрпНроЯроЩрпНроХро╛роХрпНроХрпИ, роХро░рпБрокрпНрокрпБ, роХро╛роХроорпН, роХро╛роХро╛, роХро╛роХрпНроХрпИро╡роХрпИ, роХрпЛро╡ро┐роЯрпН, рокро▒ро╡рпИ, роорпИройро╛
ЁЯРжтАНЁЯФе	ascend, ascension, emerge, fantasy, firebird, glory, immortal, phoenix, rebirth, reincarnation, reinvent, renewal, revival, revive, rise, transform, роГрокрпАройро┐роХрпНро╕рпН, роГрокрпЗрогрпНроЯро╕ро┐, роЗро▒ро╡ро╛родрпБ, роЙропро┐ро░рпНрокрпНрокро┐родрпНродро▓рпН, роХро▒рпНрокройрпИ, роЪро╛роХро╛ро╡ро░роорпН, родрпАрокрпНрокро▒ро╡рпИ, рооро▒рпБрокро┐ро▒рокрпНрокрпБ, рооро▒рпБрокро┐ро▒ро╡ро┐, рооро╛ро▒рпНро▒роорпН
ЁЯРз	animal, antarctica, bird, ornithology, penguin, роЕрогрпНроЯро╛ро░рпНроЯро┐роХро╛, рокро▒ро╡рпИ, рокрпЖроЩрпНроХрпБропро┐ройрпН, рокрпЖройрпНроХрпБропро┐ройрпН
ЁЯРи	animal, australia, bear, down, koala, marsupial, under, роХрпЛро▓ро╛, роХрпЛро╡ро╛ро▓ро╛, рокро╛ро▓рпВроЯрпНроЯро┐, рокро┐ропро░рпН, ро╡ро┐ро▓роЩрпНроХро┐ройроорпН, ро╡ро┐ро▓роЩрпНроХрпБ
ЁЯРй	animal, dog, fluffy, poodle, роЕроЯро░рпНродрпНродро┐ропро╛рой, роХрпКрогрпНроЯ, роЪрпЖро▓рпНро▓рокрпНрокро┐ро░ро╛рогро┐, роиро╛ропрпН, рокрпВроЯро┐ро▓рпН, роорпБроЯро┐, ро╡роХрпИ, ро╡ро┐ро▓роЩрпНроХро┐ройроорпН
ЁЯРк	animal, camel, desert, dromedary, hump, one, роТроЯрпНроЯроХроорпН, роТро░рпБ, роТро▒рпНро▒рпИродрпН, роХрпЗрооро▓рпН, роХрпКрогрпНроЯ, родро┐рооро┐ро▓рпН, рокро╛ро▓рпИро╡ройроорпН
ЁЯРл	animal, bactrian, camel, desert, hump, two, роЗро░роЯрпНроЯрпИродрпН, роЗро░рпБ, роТроЯрпНроЯроХроорпН, роХрпКрогрпНроЯ, родро┐рооро┐ро▓рпН, рокро╛роХрпНроЯро┐ро░ро┐ропройрпН, рокро╛ро▓рпИро╡ройроорпН
ЁЯРм	animal, beach, dolphin, flipper, ocean, роХроЯро▓рпН, роЯро╛ро▓рпНроГрокро┐ройрпН, роЯро╛ро▓рпНрокро┐ройрпН, рокро╛ро▓рпВроЯрпНроЯро┐, рокрпАроЪрпН, ро╡ро┐ро▓роЩрпНроХро┐ройроорпН
ЁЯРн	animal, mouse, роОро▓ро┐, роХрпБроЯрпНроЯро┐, роЪрпБрогрпНроЯрпЖро▓ро┐, роорпБроХроорпН, ро╡ро┐ро▓роЩрпНроХрпБ
ЁЯРо	animal, cow, farm, milk, moo, рокроЪрпБ, рокрогрпНрогрпИ, рокро╛ро▓рпН, рооро╛роЯрпБ, роорпБроХроорпН, ро╡ро┐ро▓роЩрпНроХрпБ
ЁЯРп	animal, big, cat, predator, tiger, роЯрпИроХро░рпН, родрпЗроЪро┐роп, рокрпБро▓ро┐, роорпБроХроорпН, ро╡ро┐ро▓роЩрпНроХро┐ройроорпН, ро╡ро┐ро▓роЩрпНроХрпБ
ЁЯР░	animal, bunny, pet, rabbit, роХрпБроЯрпНроЯро┐, роорпБроХроорпН, роорпБропро▓рпН, роорпКроЪроХрпН, ро╡ро┐ро▓роЩрпНроХрпБ
ЁЯР▒	animal, cat, kitten, kitty, pet, роХро┐роЯрпНроЯройрпН, роХро┐роЯрпНроЯро┐, роЪрпЖро▓рпНро▓рокрпНрокро┐ро░ро╛рогро┐, рокрпВройрпИ, рокрпВройрпИроХрпНроХрпБроЯрпНроЯро┐, роорпБроХроорпН, ро╡ро┐ро▓роЩрпНроХрпБ
ЁЯР▓	animal, dragon, fairy, fairytale, tale, роЯро┐ро░ро╛роХройрпН, роиро╛роХроорпН, рокро▒роХрпНроХрпБроорпН, рооро┐ро░рпБроХроорпН, роорпБроХроорпН, ро╡ро┐ро▓роЩрпНроХрпБ
ЁЯР│	animal, beach, ocean, spouting, whale, роЕроЯро┐роХрпНроХрпБроорпН, роХроЯро▓рпН, родрогрпНрогрпАро░рпИрокрпН, родро┐рооро┐роЩрпНроХро▓роорпН, рокрпАропрпНроЪрпНроЪро┐, ро╡ро┐ро▓роЩрпНроХро┐ройроорпН, ро╡ро┐ро▓роЩрпНроХрпБ
ЁЯР┤	animal, dressage, equine, farm, horse, horses, роХрпБродро┐ро░рпИ, роХрпКроЯрпНроЯро┐ро▓рпН, рокрогрпНрогрпИ, роорпБроХроорпН, ро╡ро┐ро▓роЩрпНроХрпБ
ЁЯР╡	animal, banana, monkey, роХрпБро░роЩрпНроХрпБ, роЪрпЗроЯрпНроЯрпИ, рооро░роорпН, роорпБроХроорпН, ро╡ро╛ро┤рпИрокрпНрокро┤роорпН, ро╡ро┐ро▓роЩрпНроХрпБ
ЁЯР╢	adorb, adorbs, animal, dog, pet, puppies, puppy, роЪрпЖро▓рпНро▓рокрпНрокро┐ро░ро╛рогро┐, роиро╛ропрпН, рокрокрпНрокро┐, рокро┐ро░ро╛рогро┐, роорпБроХроорпН, ро╡ро│ро░рпНрокрпНрокрпБрокрпН
ЁЯР╖	animal, bacon, farm, pig, pork, рокройрпНро▒ро┐, роорпБроХроорпН, ро╡ро┐ро▓роЩрпНроХрпБ
ЁЯР╕	animal, frog, родро╡ро│рпИ, роорпБроХроорпН, ро╡ро┐ро▓роЩрпНроХрпБ
ЁЯР╣	animal, hamster, pet, роорпБроХроорпН, ро╡ро┐ро▓роЩрпНроХрпБ, ро╡рпЖро│рпНро│рпЖро▓ро┐
ЁЯР║	animal, wolf, роУроиро╛ропрпН, роорпБроХроорпН, ро╡ро┐ро▓роЩрпНроХрпБ, ро╡рпБро▓рпНроГрокрпН
ЁЯР╗	animal, bear, grizzly, growl, honey, роХро░роЯро┐, роХро░роЯро┐роХрпНроХрпБроЯрпНроЯро┐, роорпБроХроорпН, ро╡ро┐ро▓роЩрпНроХрпБ
ЁЯР╗тАНтЭДя╕П	animal, arctic, bear, polar, white, роЖро░рпНроХрпНроЯро┐роХрпН, роХро░роЯро┐, рокройро┐роХрпН, ро╡рпЖро│рпНро│рпИ
ЁЯР╝	animal, bamboo, panda, роХро░роЯро┐, рокро╛рогрпНроЯро╛, рокро╛ройрпНроЯро╛, роорпБроХроорпН, ро╡ро┐ро▓роЩрпНроХрпБ
ЁЯР╜	animal, farm, nose, pig, smell, snout, рокройрпНро▒ро┐, рокройрпНро▒ро┐ропро┐ройрпН, роорпБроХроорпН, роорпВроХрпНроХрпБ, ро╡ро┐ро▓роЩрпНроХрпБ
ЁЯР╛	feet, paw, paws, print, prints, родроЯроорпН, рокро╛родродрпН, рокро╛родродрпНродроЯроорпН, рокро╛родроорпН, ро╡ро┐ро▓роЩрпНроХро┐ройрпН, ро╡ро┐ро▓роЩрпНроХрпБ
ЁЯСС	clothing, crown, family, king, medieval, queen, royal, royalty, win, роЕрогро┐роХро▓ройрпН, роЕро░роЪро┐, роЖроЯрпИ, роХро┐ро░рпАроЯроорпН, роороХрпБроЯроорпН, ро░родрпНродро┐ройроорпН, ро░ро╛роЬрпНроЬро┐ропроорпН, ро░ро╛роЬрпНропроорпН, ро░ро╛рогро┐
ЁЯСТ	clothe, clothes, clothing, garden, hat, hats, party, woman, роЕрогро┐роХро▓ройрпН, роЖроЯрпИ, родрпКрокрпНрокро┐, рокро╛ро░рпНроЯрпНроЯро┐, рокрпЖрогрпНроХро│рпН, ро╣рпЗроЯрпН
ЁЯСУя╕П	clothing, eye, eyeglasse, eyeglasses, eyewear, glasse, glasses, роЕрогро┐роХро▓ройрпН, роЖроЯрпИ, роХрогрпН, роХрогрпНрогро╛роЯро┐, роХрогрпНрогро╛роЯро┐роХро│рпН, роХро┐ро│ро╛ро╕рпН, роХрпЛроЯрпИ, рокро╛ро░рпНро╡рпИ, роорпВроХрпНроХрпБ, роорпВроХрпНроХрпБроХрпН
ЁЯСФ	clothing, employed, necktie, seriou, serious, shirt, tie, роГрокро╛ро░рпНрооро▓рпН, роЕрогро┐роХро▓ройрпН, роЕро▓рпБро╡ро▓роХроорпН, роЖроЯрпИ, роХро┤рпБродрпНродрпБ, роЪро░рпНроЯрпН, роЯрпИ, родрпБрогро┐, рокрогро┐, ро╡рпЗро▓рпИ, ро╖ро░рпНроЯрпН
ЁЯСХ	blue, casual, clothe, clothes, clothing, collar, dressed, shirt, shopping, tshirt, weekend, роЕрогро┐роХро▓ройрпН, роЖроЯрпИ, роЖрогрпН, роЙроЯрпИ, роХро╛ро▓ро░рпН, роХрпЗро╖рпБро╡ро▓рпН, роЪроЯрпНроЯрпИ, роЪро░рпНроЯрпН, роЯро┐, роЯро┐ро░рпЖро╕рпН, роорпЗро▓ро╛роЯрпИ, ро╖ро░рпНроЯрпН, ро╖ро╛рокрпНрокро┐роЩрпН
ЁЯСЦ	blue, casual, clothe, clothes, clothing, denim, dressed, jean, jeans, pant, pants, shopping, trouser, trousers, weekend, роЖроЯрпИ, роЖроЯрпИроХро│рпН, роЙроЯрпИ, роХро╛ро▒рпНроЪроЯрпНроЯрпИ, роЬрпАройрпНро╕рпН, роЯро┐ро░ро╡рпБроЪро░рпН, роЯро┐ро░ро╡рпБроЪро░рпНро╕рпН, роЯро┐ро░рпЖро╕рпН, роЯрпЖройро┐роорпН, рокрпЗройрпНроЯрпН
ЁЯСЧ	clothe, clothes, clothing, dres, dress, dressed, fancy, shopping, роГрокро┐ро░ро╛роХрпН, роЖроЯрпИ, роЙроЯрпИ, роХро╡рпБройрпН, роЯро┐ро░рпЖро╕рпН, рокрпЖрогрпНроХро│рпН, ро╖ро╛рокрпНрокро┐роЩрпН
ЁЯСШ	clothing, comfortable, kimono, роЕрогро┐роХро▓ройрпН, роЖроЯрпИ, роЙроЯрпИ, роЙроЯрпИроХро│рпН, роХро┐роорпЛройрпЛ, роЬрокрпНрокро╛ройро┐роп, рокрпЖрогрпН
ЁЯСЩ	bathing, beach, bikini, clothing, pool, suit, swim, роЕрогро┐роХро▓ройрпН, роЖроЯрпИ, роЙроЯрпИ, роХро╡ро░рпНроЪрпНроЪро┐, роХрпБро│роорпН, роХрпБро│ро┐рокрпНрокродро▒рпНроХро╛рой, роирпАроЪрпНроЪро▓ро╛роЯрпИ, роирпАроЪрпНроЪро▓рпБроЯрпИ, роирпАроЪрпНроЪро▓рпН, рокро┐роХро┐ройро┐, ро╕рпНро╡ро┐роорпНрооро┐роЩрпН
ЁЯСЪ	blouse, clothe, clothes, clothing, collar, dres, dress, dressed, lady, shirt, shopping, woman, роЕрогро┐роХро▓ройрпН, роЖроЯрпИ, роЖроЯрпИроХро│рпН, роЙроЯрпИ, роЙроЯрпИроХро│рпН, роЪроЯрпНроЯрпИ, рокрпЖрогрпН, рокрпЖрогрпНроХро│ро┐ройрпН, рокрпЖрогрпНроХро│рпН, роорпЗро▓рпН, ро╖ро░рпНроЯрпН
ЁЯСЫ	clothe, clothes, clothing, coin, dres, dress, fancy, handbag, purse, shopping, роЕрогро┐роХро▓ройрпН, роЖроЯрпИ, рокрогрокрпНрокрпИ, рокрогроорпН, рокро░рпНро╕рпН, рокрпКро░рпБро│рпН, роорогро┐, ро╖ро╛рокрпНрокро┐роЩрпН
ЁЯСЬ	bag, clothe, clothes, clothing, dres, dress, handbag, lady, purse, shopping, роЕрогро┐роХро▓ройрпН, роЖроЯрпИ, роХро┐ро│роЯрпНроЪрпН, роХрпИрокрпНрокрпИ, рокрпЗроХрпН, рокрпИ, рокрпКро░рпБро│рпН, ро╖ро╛рокрпНрокро┐роЩрпН, ро╣рпЗрогрпНроЯрпН
ЁЯСЭ	bag, clothe, clothes, clothing, clutch, dres, dress, handbag, pouch, purse, роЕрогро┐роХро▓ройрпН, роЖроЯрпИ, роХро┐ро│роЯрпНроЪрпН, роХрпИрокрпНрокрпИ, рокро╡рпБроЪрпН, рокрпЗроХрпН, рокрпИ, рокрпКро░рпБро│рпН, ро╣рпЗрогрпНроЯрпН
ЁЯСЮ	brown, clothe, clothes, clothing, feet, foot, kick, man, shoe, shoes, shopping, роГрокро╛ро░рпНрооро▓рпН, роЕрогро┐роХро▓ройрпН, роЕро▓рпБро╡ро▓роХроорпН, роЖроЯрпИ, роЖрогрпНроХро│рпБроХрпНроХро╛рой, роЖрогрпНроХро│рпН, роЖрокро┐ро╕рпН, роХро╛ро▓рогро┐, рокро╛родроорпН, рокро┐ро░ро╡рпБройрпН, рокрпКро░рпБро│рпН, ро╖ро╛рокрпНрокро┐роЩрпН, ро╖рпВ
ЁЯСЯ	athletic, clothe, clothes, clothing, fast, kick, running, shoe, shoes, shopping, sneaker, tenni, tennis, роЕрогро┐роХро▓ройрпН, роЕродрпНро▓рпЖроЯро┐роХрпНро╕рпН, роЖроЯрпИ, роЙродрпИ, роЯрпЖройрпНройро┐ро╕рпН, родроЯроХро│, рокрпКро░рпБро│рпН, рооро┐ро░рпБродрпБро╡ро╛рой, ро░ройрпНройро┐роЩрпН, ро╡рпАро░ро░рпНроХро│рпБроХрпНроХро╛рой, ро╖рпВ, ро╕рпНроирпАроХрпНроХро░рпН
ЁЯСа	clothe, clothes, clothing, dres, dress, fashion, heel, heeled, heels, high, shoe, shoes, shopping, stiletto, woman, роЕрогро┐роХро▓ройрпН, роЖроЯрпИ, роЪрпЖро░рпБрокрпНрокрпБ, ро╖рпВ, ро╣рпАро▓рпН, ро╣рпАро▓рпНро╕рпН, ро╣рпИ, ро╣рпИро╣рпАро▓рпН
ЁЯСб	clothing, sandal, shoe, woman, роЕрогро┐роХро▓ройрпН, роЖроЯрпИ, роЪро╛рогрпНроЯро▓рпН, роЪрпЖро░рпБрокрпНрокрпБ, рокрпЖрогрпНроХро│рпН, ро╣рпАро▓рпНро╕рпН
ЁЯСв	boot, clothe, clothes, clothing, dres, dress, shoe, shoes, shopping, woman, роЕрогро┐роХро▓ройрпН, роЖроЯрпИ, роХро╛ро▓рогро┐, рокрпВроЯрпН, рокрпВроЯрпНро╕рпН, рокрпЖрогрпНроХро│рпН, ро╖рпВ
ЁЯСж	boy
ЁЯСз	girl
ЁЯСи	man
ЁЯСитАНтЪХя╕П	doctor, health, healthcare, man, nurse, therapist, worker, роЖрогрпН, роЙроЯро▓рпНроиро▓роорпН, роХро┐ро│ро┐ройро┐роХрпН, роЪро┐роХро┐роЪрпНроЪрпИ, роЪро┐роХро┐роЪрпНроЪрпИропро╛ро│ро░рпН, роЯро╛роХрпНроЯро░рпН, роирокро░рпН, роиро░рпНро╕рпН, рооро░рпБродрпНродрпБро╡рооройрпИ, рооро░рпБродрпНродрпБро╡ро░рпН
ЁЯСитАНтЪЦя╕П	judge, justice, law, man, scale, scales, роЖрогрпН, роЪроЯрпНроЯроорпН, родрпАро░рпНрокрпНрокрпБ, роирокро░рпН, роиро┐ропро╛ропроорпН, роирпАродро┐, роирпАродро┐рокродро┐, роирпАродро┐рооройрпНро▒роорпН, ро╡ро┤роХрпНроХрпБ
ЁЯСитАНтЬИя╕П	man, pilot, plane, роЖрогрпН, роУроЯрпНроЯрпБроиро░рпН, роирокро░рпН, рокрпИро▓роЯрпН, ро╡ро┐рооро╛рой, ро╡ро┐рооро╛ройроорпН, ро╡ро┐рооро╛ройро┐
ЁЯСитАНЁЯМ╛	farmer, gardener, man, rancher, роЖрогрпН, родрпЛроЯрпНроЯроХрпНроХро╛ро░ро░рпН, роирокро░рпН, рокрогрпНрогрпИропро╛ро│рпН, ро╡ро┐ро╡роЪро╛ропроорпН, ро╡ро┐ро╡роЪро╛ропро┐
ЁЯСитАНЁЯН│	chef, cook, man, роЖрогрпН, роЪроорпИропро▓рпН, роЪрпЖроГрокрпН, роирокро░рпН, ро╡ро▓рпНро▓рпБроиро░рпН
ЁЯСитАНЁЯН╝	baby, dad, father, feed, feeding, man, nanny, newborn, nursing, роЕрокрпНрокро╛, роЖрогрпН, роХрпБро┤роирпНродрпИ, роХрпБро┤роирпНродрпИроХрпНроХрпБ, родроирпНродрпИ, роирокро░рпН, рокро╛ро▓рпВроЯрпНроЯрпБродро▓рпН, рокро╛ро▓рпВроЯрпНроЯрпБроорпН
ЁЯСитАНЁЯОУ	graduate, man, student, роЖрогрпН, роХро▓рпНро▓рпВро░ро┐, роирокро░рпН, рокроЯро┐рокрпНрокрпБ, рокроЯрпНроЯроорпН, рооро╛рогро╡ройрпН
ЁЯСитАНЁЯОд	actor, entertainer, man, rock, rockstar, singer, star, роЖрогрпН, роироЯро┐роХро░рпН, роирокро░рпН, рокро╛роЯроХро░рпН, рокрпКро┤рпБродрпБрокрпЛроХрпНроХрпБ, ро░ро╛роХрпНро╕рпНроЯро╛ро░рпН
ЁЯСитАНЁЯОи	artist, man, palette, роЖрогрпН, роУро╡ро┐ропроорпН, роУро╡ро┐ропро░рпН, роХро▓рпИ, роирокро░рпН, рокрпЖропро┐ройрпНроЯрпН
ЁЯСитАНЁЯПл	instructor, lecturer, man, professor, teacher, роЖроЪро┐ро░ро┐ропро░рпН, роЖрогрпН, роирокро░рпН, рокро│рпНро│ро┐, ро╡ро┐ро░ро┐ро╡рпБро░рпИропро╛ро│ро░рпН
ЁЯСитАНЁЯПн	assembly, factory, industrial, man, worker, роЖрогрпН, роЖро▓рпИ, родрпКро┤ро┐ро▒рпНроЪро╛ро▓рпИ, родрпКро┤ро┐ро▓ро╛ро│ро┐, роирокро░рпН
ЁЯСитАНЁЯТ╗	coder, computer, developer, inventor, man, software, technologist, роЖрогрпН, роХрогро┐ройро┐, роХроорпНрокрпНропрпВроЯрпНроЯро░рпН, родрпКро┤ро┐ро▓рпНроирпБроЯрпНрокро╡ро┐ропро▓ро╛ро│ро░рпН, роирокро░рпН, роорпЖройрпНрокрпКро░рпБро│рпН, ро╡ро▓рпНро▓рпБроиро░рпН
ЁЯСитАНЁЯТ╝	architect, busines, business, collar, man, manager, office, white, worker, роЕродро┐роХро╛ро░ро┐, роЕро▓рпБро╡ро▓роХроорпН, роЖрогрпН, роирокро░рпН, рокрогро┐ропро╛ро│ро░рпН, роорпЗро▓ро╛ро│ро░рпН, ро╡ро░рпНродрпНродроХроорпН
ЁЯСитАНЁЯФз	electrician, man, mechanic, plumber, tradesperson, роЖрогрпН, роирокро░рпН, рокро┤рпБродрпБ, рокро╛ро░рпНрокрпНрокро╡ро░рпН, рокро┐ро│роорпНрокро░рпН, роорпЖроХрпНроХро╛ройро┐роХрпН
ЁЯСитАНЁЯФм	biologist, chemist, engineer, man, mathematician, physicist, scientist, роЕро▒ро┐ро╡ро┐ропро▓рпН, роЖрогрпН, роХрпЖрооро┐ро╕рпНроЯрпН, роирокро░рпН, ро╡ро┐роЮрпНроЮро╛ройро┐
ЁЯСитАНЁЯжп	accessibility, blind, cane, man, probing, white, роЖрогрпН, роХрогрпНрокро╛ро░рпНро╡рпИропро▒рпНро▒ро╡ро░рпН, роХрпИродрпНродроЯро┐ропрпБроЯройрпН, роироЯроХрпНроХрпБроорпН, роирокро░рпН, рокро╛ро░рпНро╡рпИропро▒рпНро▒ро╡ро░рпН, рокро╛ро░рпНро╡рпИропро▒рпНро▒рпЛро░рпН, рооро╛ро▒рпНро▒рпБродрпНродро┐ро▒ройро╛ро│ро┐
ЁЯСитАНЁЯжптАНтЮбя╕П	accessibility, blind, cane, facing, man, probing, right, white
ЁЯСитАНЁЯж╝	accessibility, in, man, motorized, wheelchair, роЕрооро░рпНроирпНродро┐ро░рпБроХрпНроХрпБроорпН, роЖрогрпН, роЗропроЩрпНроХрпБроорпН, роЪроХрпНроХро░, роЪрпЗро░рпН, роиро╛ро▒рпНроХро╛ро▓ро┐, роиро╛ро▒рпНроХро╛ро▓ро┐ропро┐ро▓рпН, рооро┐ройрпНройро╛ро▒рпНро▒ро▓ро┐ро▓рпН, ро╡рпАро▓рпН
ЁЯСитАНЁЯж╝тАНтЮбя╕П	accessibility, facing, in, man, motorized, right, wheelchair
ЁЯСитАНЁЯж╜	accessibility, in, man, manual, wheelchair, роЕрооро░рпНроирпНродро┐ро░рпБроХрпНроХрпБроорпН, роЖрогрпН, роЖро▒рпНро▒ро▓ро┐ро▓рпН, роЗропроХрпНроХрооро┐ройрпНроорпИ, роЗропроЩрпНроХрпБроорпН, роЗропро▓ро╛родро╡ро░рпН, роЪроХрпНроХро░, роЪрпЗро░рпН, роироЯроХрпНроХ, роирокро░рпН, роиро╛ро▒рпНроХро╛ро▓ро┐, роиро╛ро▒рпНроХро╛ро▓ро┐ропро┐ро▓рпН, рооройро┐род, рооро╛ро▒рпНро▒рпБродрпНродро┐ро▒ройро╛ро│ро┐, роорпБроЯрооро╛ройро╡ро░рпН, ро╡рпАро▓рпН
ЁЯСитАНЁЯж╜тАНтЮбя╕П	accessibility, facing, in, man, manual, right, wheelchair
ЁЯСитАНЁЯЪА	astronaut, man, rocket, space, роЖрогрпН, роЪро╛роЯрпНроЯро┐ро▓рпИроЯрпН, роирокро░рпН, ро░ро╛роХрпНроХрпЖроЯрпН, ро╡ро┐рогрпНро╡рпЖро│ро┐, ро╡рпАро░ро░рпН
ЁЯСитАНЁЯЪТ	fire, firefighter, firetruck, man, роЖрогрпН, родрпА, родрпАропрогрпИрокрпНрокрпБ, роирокро░рпН, ро╡ро┐рокродрпНродрпБ, ро╡рпАро░ро░рпН
ЁЯСй	woman
ЁЯСйтАНтЪХя╕П	doctor, health, healthcare, nurse, therapist, woman, worker, роХро┐ро│ро┐ройро┐роХрпН, роЪро┐роХро┐роЪрпНроЪрпИ, роЪро┐роХро┐роЪрпНроЪрпИропро╛ро│ро░рпН, роЯро╛роХрпНроЯро░рпН, роирокро░рпН, роиро░рпНро╕рпН, рокрпЖрогрпН, рооро░рпБродрпНродрпБро╡рооройрпИ, рооро░рпБродрпНродрпБро╡ро░рпН
ЁЯСйтАНтЪЦя╕П	judge, justice, law, scale, scales, woman, роЪроЯрпНроЯроорпН, родрпАро░рпНрокрпНрокрпБ, роирокро░рпН, роиро┐ропро╛ропроорпН, роирпАродро┐рокродро┐, роирпАродро┐рооройрпНро▒роорпН, рокрпЖрогрпН, ро╡ро┤роХрпНроХрпБ
ЁЯСйтАНтЬИя╕П	pilot, plane, woman, роУроЯрпНроЯрпБроиро░рпН, роирокро░рпН, рокрпЖрогрпН, рокрпИро▓роЯрпН, ро╡ро┐рооро╛рой, ро╡ро┐рооро╛ройроорпН, ро╡ро┐рооро╛ройро┐
ЁЯСйтАНЁЯМ╛	farmer, gardener, rancher, woman, родрпЛроЯрпНроЯроХрпНроХро╛ро░ро░рпН, роирокро░рпН, рокрогрпНрогрпИропро╛ро│рпН, рокрпЖрогрпН, ро╡ро┐ро╡роЪро╛ропроорпН, ро╡ро┐ро╡роЪро╛ропро┐
ЁЯСйтАНЁЯН│	chef, cook, woman, роЪроорпИропро▓рпН, роЪрпЖроГрокрпН, роирокро░рпН, рокрпЖрогрпН, ро╡ро▓рпНро▓рпБроиро░рпН
ЁЯСйтАНЁЯН╝	baby, feed, feeding, mom, mother, nanny, newborn, nursing, woman, роЕроорпНрооро╛, роХрпБро┤роирпНродрпИ, роХрпБро┤роирпНродрпИроХрпНроХрпБ, родро╛ропрпН, роирокро░рпН, рокро╛ро▓рпВроЯрпНроЯрпБродро▓рпН, рокро╛ро▓рпВроЯрпНроЯрпБроорпН, рокрпЖрогрпН
ЁЯСйтАНЁЯОУ	graduate, student, woman, роХро▓рпНро▓рпВро░ро┐, роирокро░рпН, рокроЯрпНроЯроорпН, рокрпЖрогрпН, рооро╛рогро╡ро┐
ЁЯСйтАНЁЯОд	actor, entertainer, rock, rockstar, singer, star, woman, роироЯро┐роХро░рпН, роирокро░рпН, рокро╛роЯроХро░рпН, рокрпЖрогрпН, рокрпКро┤рпБродрпБрокрпЛроХрпНроХрпБ, ро░ро╛роХрпНро╕рпНроЯро╛ро░рпН
ЁЯСйтАНЁЯОи	artist, palette, woman, роУро╡ро┐ропроорпН, роУро╡ро┐ропро░рпН, роХро▓рпИ, роирокро░рпН, рокрпЖрогрпН, рокрпЖропро┐ройрпНроЯрпН, ро╡ро░рпИродро▓рпН
ЁЯСйтАНЁЯПл	instructor, lecturer, professor, teacher, woman, роЖроЪро┐ро░ро┐ропро░рпН, роирокро░рпН, рокро│рпНро│ро┐, рокрпЖрогрпН, ро╡ро┐ро░ро┐ро╡рпБро░рпИропро╛ро│ро░рпН
ЁЯСйтАНЁЯПн	assembly, factory, industrial, woman, worker, роЖро▓рпИ, родрпКро┤ро┐ро▒рпНроЪро╛ро▓рпИ, родрпКро┤ро┐ро▓ро╛ро│ро┐, роирокро░рпН, рокрпЖрогрпН
ЁЯСйтАНЁЯТ╗	coder, computer, developer, inventor, software, technologist, woman, роХрогро┐ройро┐, роХроорпНрокрпНропрпВроЯрпНроЯро░рпН, роЯрпЖро╡ро▓рокрпНрокро░рпН, родрпКро┤ро┐ро▓рпНроирпБроЯрпНрокро╡ро┐ропро▓ро╛ро│ро░рпН, роирокро░рпН, рокрпЖрогрпН, роорпЖройрпНрокрпКро░рпБро│рпН, ро╡ро▓рпНро▓рпБроиро░рпН
ЁЯСйтАНЁЯТ╝	architect, busines, business, collar, manager, office, white, woman, worker, роЕродро┐роХро╛ро░ро┐, роЕро▓рпБро╡ро▓роХроорпН, роирокро░рпН, рокрогро┐ропро╛ро│ро░рпН, рокрпЖрогрпН, роорпЗро▓ро╛ро│ро░рпН
ЁЯСйтАНЁЯФз	electrician, mechanic, plumber, tradesperson, woman, роОро▓роХрпНроЯрпНро░рпАроЪро┐ропройрпН, роирокро░рпН, рокро┤рпБродрпБ, рокро╛ро░рпНрокрпНрокро╡ро░рпН, рокро┐ро│роорпНрокро░рпН, рокрпЖрогрпН, роорпЖроХрпНроХро╛ройро┐роХрпН
ЁЯСйтАНЁЯФм	biologist, chemist, engineer, mathematician, physicist, scientist, woman, роЕро▒ро┐ро╡ро┐ропро▓ро╛ро│ро░рпН, роЕро▒ро┐ро╡ро┐ропро▓рпН, роЙропро┐ро░ро┐ропро▓ро╛ро│ро░рпН, роирокро░рпН, рокрпЖрогрпН, рокрпКро▒ро┐ропро┐ропро▓ро╛ро│ро░рпН, ро╡ро┐роЮрпНроЮро╛ройро┐
ЁЯСйтАНЁЯжп	accessibility, blind, cane, probing, white, woman, роХрогрпНрокро╛ро░рпНро╡рпИропро▒рпНро▒ро╡ро░рпН, роХрпИродрпНродроЯро┐ропрпБроЯройрпН, роироЯроХрпНроХрпБроорпН, роирокро░рпН, рокро╛ро░рпНро╡рпИропро▒рпНро▒ро╡ро░рпН, рокро╛ро░рпНро╡рпИропро▒рпНро▒рпЛро░рпН, рокро╛ро░рпНро╡рпИропро┐ро┤роирпНродро╡ро░рпН, рокрпЖрогрпН, рооро╛ро▒рпНро▒рпБродрпНродро┐ро▒ройро╛ро│ро┐
ЁЯСйтАНЁЯжптАНтЮбя╕П	accessibility, blind, cane, facing, probing, right, white, woman
ЁЯСйтАНЁЯж╝	accessibility, in, motorized, wheelchair, woman, роЕрооро░рпНроирпНродро┐ро░рпБроХрпНроХрпБроорпН, роЗропроХрпНроХрооро┐ройрпНроорпИ, роЗропроЩрпНроХро╛роорпИ, роЗропроЩрпНроХрпБроорпН, роЗропро▓ро╛роорпИ, роЪроХрпНроХро░, роЪроХрпНроХро░роиро╛ро▒рпНроХро╛ро▓ро┐, роЪрпЖропро▓ро┐ро┤роирпНродро╡ро░рпН, роирокро░рпН, роиро╛ро▒рпНроХро╛ро▓ро┐ропро┐ро▓рпН, рокрпЖрогрпН, рооро┐ройрпНройро╛ро▒рпНро▒ро▓ро┐ро▓рпН, роорпБроЯрооро╛ройро╡ро░рпН
ЁЯСйтАНЁЯж╝тАНтЮбя╕П	accessibility, facing, in, motorized, right, wheelchair, woman
ЁЯСйтАНЁЯж╜	accessibility, in, manual, wheelchair, woman, роЕрооро░рпНроирпНродро┐ро░рпБроХрпНроХрпБроорпН, роЖро▒рпНро▒ро▓ро┐ро▓рпН, роЗропроЩрпНроХрпБроорпН, роЗропро▓ро╛родро╡ро░рпН, роЗропро▓ро╛роорпИ, роЙроЯро▓рпН, роЪроХрпНроХро░, родро┐ро▒ройро╛ро│ро┐, роироЯроХрпНроХ, роиро╛ро▒рпНроХро╛ро▓ро┐, роиро╛ро▒рпНроХро╛ро▓ро┐ропро┐ро▓рпН, рокрпЖрогрпН, рооройро┐род, рооро╛ро▒рпНро▒рпБродрпН
ЁЯСйтАНЁЯж╜тАНтЮбя╕П	accessibility, facing, in, manual, right, wheelchair, woman
ЁЯСйтАНЁЯЪА	astronaut, rocket, space, woman, роЪро╛роЯрпНроЯро┐ро▓рпИроЯрпН, роирокро░рпН, рокрпЖрогрпН, ро░ро╛роХрпНроХрпЖроЯрпН, ро╡ро┐рогрпНроХро▓роорпН, ро╡ро┐рогрпНро╡рпЖро│ро┐, ро╡рпАро░ро░рпН
ЁЯСйтАНЁЯЪТ	fire, firefighter, firetruck, woman, родрпА, родрпАропрогрпИрокрпНрокрпБ, роирокро░рпН, рокрпЖрогрпН, ро╡ро┐рокродрпНродрпБ, ро╡рпАро░ро░рпН
ЁЯСо	apprehend, arrest, citation, cop, law, officer, over, police, pulled, undercover, роЕродро┐роХро╛ро░ро┐, роЖрогрпН, роЖрокро┐роЪро░рпН, роЖрокро┐ро╕ро░рпН, роХро╛ро╡ро▓ро░рпН, роХро╛ро╡ро▓рпНродрпБро▒рпИ, роХрпИродрпБ, роЪроЯрпНроЯроорпН, роирокро░рпН, рокрпЛро▓ро┐ро╕рпН, рокрпЛро▓рпАро╕рпН, роороХрпНроХро│рпН
ЁЯСотАНтЩАя╕П	apprehend, arrest, citation, cop, law, officer, over, police, pulled, undercover, woman, роЕродро┐роХро╛ро░ро┐, роХро╛ро╡ро▓ро░рпН, роХро╛ро╡ро▓рпНродрпБро▒рпИ, роХрпИродрпБ, роирокро░рпН, рокрпЖрогрпН, рокрпЛро▓ро┐ро╕рпН, рокрпЛро▓рпАро╕рпН
ЁЯСотАНтЩВя╕П	apprehend, arrest, citation, cop, law, man, officer, over, police, pulled, undercover, роЕродро┐роХро╛ро░ро┐, роЖрогрпН, роХро╛ро╡ро▓ро░рпН, роХро╛ро╡ро▓рпНродрпБро▒рпИ, рокрпЛро▓рпАро╕рпН
ЁЯСп	bestie, bff, bunny, counterpart, dancer, double, ear, ears, identical, pair, party, partying, people, soulmate, twin, twinsies, twinsy, роЖродрпНроо, роЗрогрпИ, роЙро│рпНро│, роХро╛родрпБ, роХро╛родрпБроХро│рпБроЯройрпН, роХро╛родрпБроХро│рпН, роЪрпЖро▓рпНро▓рпБроорпН, родрпЛро┤ро┐, роироЯройрооро╛роЯрпБрокро╡ро░рпН, рокро╛ро░рпНроЯрпНроЯро┐, рокро╛ро░рпНроЯрпНроЯро┐роХрпНроХрпБроЪрпН, рокрпЖрогрпНроХро│рпН, роорпБропро▓рпН
ЁЯСптАНтЩАя╕П	bestie, bff, bunny, counterpart, dancer, double, ear, ears, identical, pair, party, partying, people, soulmate, twin, twinsies, twinsy, women, роХро▓рпИроЮро░рпНроХро│рпН, роХро╛родрпБ, роироЯройроХрпН, роироЯройрооро╛роЯрпБроорпН, рокро╛ро░рпНроЯрпНроЯро┐, рокрпЖрогрпНроХро│рпН, роорпБропро▓рпН
ЁЯСптАНтЩВя╕П	bestie, bff, bunny, counterpart, dancer, double, ear, ears, identical, men, pair, party, partying, people, soulmate, twin, twinsies, twinsy, роЖрогрпНроХро│рпН, роЗро░роЯрпНроЯрпИропро░рпН, роЙропро┐ро░рпН, роХро▓рпИроЮро░рпНроХро│рпН, роХро╛родрпБ, роироЯройроХрпН, роироЯройрооро╛роЯрпБроорпН, роирогрпНрокро░рпН, роирокро░рпН, рокро╛ро░рпНроЯрпНроЯро┐, роорпБропро▓рпН
ЁЯС░	person, veil, wedding, роЕрогро┐роирпНрод, роХро▓рпНропро╛рогроорпН, родро┐ро░рпБроорог, родро┐ро░рпБроорогроорпН, роирокро░рпН, рокрпЖрогрпН, роорогрокрпНрокрпЖрогрпН, роорогроороХро│рпН, роорпБроХрпНроХро╛роЯрпБ
ЁЯС░тАНтЩАя╕П	bride, veil, wedding, woman, роЕрогро┐роирпНрод, рокрпЖрогрпН, роорпБроХрпНроХро╛роЯрпБ
ЁЯС░тАНтЩВя╕П	man, veil, wedding, роЕрогро┐роирпНрод, роЖрогрпН, роорпБроХрпНроХро╛роЯрпБ
ЁЯС▓	cap, chinese, gua, guapi, hat, mao, person, pi, skullcap, роЕрогро┐роирпНродро╡ро░рпН, роЖрогрпН, роТроЯрпНроЯрпБродрпНродрпКрокрпНрокро┐ропрпБроЯройрпН, роХрпВроЯро┐роп, роЪрпАрой, роЪрпАройродрпН, родрпКрокрпНрокро┐, роирокро░рпН, роороХрпНроХро│рпН
ЁЯС│	person, turban, wearing, роЕрогро┐роирпНродро╡ро░рпН, роЖрогрпН, роЪро┐роЩрпН, роЯро░рпНрокройрпН, родро▓рпИрокрпНрокро╛роХрпИ, роирокро░рпН, роороХрпНроХро│рпН
ЁЯС│тАНтЩАя╕П	turban, wearing, woman, роЕрогро┐роирпНрод, роЯро░рпНрокройрпН, родро▓рпИрокрпНрокро╛роХрпИ, роирокро░рпН, рокрпЖрогрпН
ЁЯС│тАНтЩВя╕П	man, turban, wearing, роЕрогро┐роирпНрод, роЖрогрпН, роЪро┐роЩрпН, родро▓рпИрокрпНрокро╛роХрпИ
ЁЯС╢	baby, infant, newborn
ЁЯС╖	build, construction, fix, hardhat, hat, man, person, rebuild, remodel, repair, work, worker, роХроЯрпНроЯрпБрооро╛рой, роХроЯрпНроЯрпБрооро╛ройроорпН, родро▓рпИроХрпНроХро╡роЪроорпН, родрпКро┤ро┐ро▓ро╛ро│ро┐, роирокро░рпН, рокрогро┐, рокрогро┐ропро╛ро│ро░рпН, рокро┤рпБродрпБ, рокро╛ро░рпНродрпНродро▓рпН, роороХрпНроХро│рпН, ро╣рпЖро▓рпНроорпЖроЯрпН
ЁЯС╖тАНтЩАя╕П	build, construction, fix, hardhat, hat, man, rebuild, remodel, repair, woman, work, worker, роХроЯрпНроЯрпБрооро╛ройродрпН, роХроЯрпНроЯрпБрооро╛ройроорпН, родрпКро┤ро┐ро▓ро╛ро│ро░рпН, родрпКро┤ро┐ро▓ро╛ро│ро┐, роирокро░рпН, рокрпЖрогрпН, ро╣рпЖро▓рпНроорпЖроЯрпН
ЁЯС╖тАНтЩВя╕П	build, construction, fix, hardhat, hat, man, rebuild, remodel, repair, work, worker, роЖрогрпН, роХроЯрпНроЯрпБрооро╛ройродрпН, роХроЯрпНроЯрпБрооро╛ройроорпН, родрпКро┤ро┐ро▓ро╛ро│ро░рпН, родрпКро┤ро┐ро▓ро╛ро│ро┐
ЁЯС╕	crown, fairy, fairytale, fantasy, princes, princess, queen, royal, royalty, tale, роЗро│ро╡ро░роЪро┐, роХродрпИроХро│рпН, родрпЗро╡родрпИ, родрпЗро╡родрпИроХрпН, роирокро░рпН, рокрпЖрогрпН, роороХрпНроХро│рпН, ро░ро╛рогро┐
ЁЯТВ	buckingham, guard, helmet, london, palace, роЕро░рогрпНрооройрпИ, роХро╛ро╡ро▓ро░рпНроХро│рпН, роХро╛ро╡ро▓ро╛ро│ро┐, роирокро░рпН, рокроХрпНроХро┐роЩрпНроХро╛роорпН, рокро╛родрпБроХро╛ро╡ро▓ро░рпН, роороХрпНроХро│рпН
ЁЯТВтАНтЩАя╕П	buckingham, guard, helmet, london, palace, woman, роЕро░рогрпНрооройрпИ, роирокро░рпН, рокроХрпНроХро┐роЩрпНроХро╛роорпН, рокро╛родрпБроХро╛ро╡ро▓ро░рпН, рокрпЖрогрпН, ро▓рогрпНроЯройрпН, ро╣рпЖро▓рпНроорпЖроЯрпН
ЁЯТВтАНтЩВя╕П	buckingham, guard, helmet, london, man, palace, роЖрогрпН, рокро╛родрпБроХро╛ро╡ро▓ро░рпН
ЁЯТГ	dance, dancer, dancing, elegant, festive, flair, flamenco, groove, let, salsa, tango, woman, роЖроЯро▓ро╛роорпН, роХро▓рпИроЮро░рпН, роХрпБродрпВроХро▓роорпН, роЪро▓рпНроЪро╛, роироЯройроХрпН, роироЯройроорпН, роирокро░рпН, роиро╛роЯрпНроЯро┐ропроорпН, рокрпЖрогрпН
ЁЯТД	cosmetic, cosmetics, date, lipstick, makeup, роЕрокрпН, роЕро▓роЩрпНроХро╛ро░роорпН, роЙродроЯрпНроЯрпБроЪрпНроЪро╛ропроорпН, роХро╛ро╕рпНроорпЖроЯро┐роХрпН, рокрпКро░рпБро│рпН, роорпЗроХрпН, роорпЗроХрпНроЕрокрпН, роорпЗроХрпНроХрокрпН, ро▓ро┐рокрпНро╕рпНроЯро┐роХрпН
ЁЯТЖ	getting, headache, massage, person, relax, relaxing, salon, soothe, spa, tension, therapy, treatment, роЕро┤роХрпБ, роЪро▓рпВройрпН, роЪрпЖропрпНродрпБроХрпКро│рпНрокро╡ро░рпН, родро▓рпИ, родро▓рпИро╡ро▓ро┐, роирокро░рпН, рокрпЖрогрпН, роороЪро╛роЬрпН, роорпБроХ, роорпБроХроорпН
ЁЯТЖтАНтЩАя╕П	getting, headache, massage, relax, relaxing, salon, soothe, spa, tension, therapy, treatment, woman, роХрпКро│рпНро│рпБроорпН, роЪро▓рпВройрпН, роЪрпЖропрпНродрпБ, родро▓рпИ, родро▓рпИропро┐ро▓рпН, рокрпЖрогрпН, роороЪро╛роЬрпН
ЁЯТЖтАНтЩВя╕П	getting, headache, man, massage, relax, relaxing, salon, soothe, spa, tension, therapy, treatment, роЕро┤роХрпБрокроЯрпБродрпНродрпБродро▓рпН, роЖрогрпН, роУропрпНро╡рпБ, роХрпКро│рпНро│рпБроорпН, роЪро▓рпВройрпН, роЪрпЖропрпНродрпБ, роЯрпЖройрпНро╖ройрпН, родро▓рпИ, родро▓рпИропро┐ро▓рпН, родро▓рпИро╡ро▓ро┐, родро┐ро░рпБродрпНродроХроорпН, роирокро░рпН, роороЪро╛роЬрпН, роорпБроЯро┐
ЁЯТЗ	barber, beauty, chop, cosmetology, cut, getting, groom, hair, haircut, parlor, person, shear, shears, style, роЕро▓роЩрпНроХро╛ро░роорпН, роЕро┤роХрпБ, роХрпВроирпНродро▓рпН, роЪро┐роХрпИ, роирокро░рпН, роиро┐ро▓рпИропроорпН, рокро░ро╛рооро░ро┐рокрпНрокрпБ, рокро╛ро░рпНро▓ро░рпН, рокро┐ропрпВроЯрпНроЯро┐, рокрпЖрогрпН, роорпБроЯро┐, роорпБроЯро┐родрпНродро┐ро░рпБродрпНродроорпН, ро╡рпЖроЯрпНроЯрпБ, ро╡рпЖроЯрпНроЯрпБродро▓рпН
ЁЯТЗтАНтЩАя╕П	barber, beauty, chop, cosmetology, cut, getting, groom, hair, haircut, parlor, person, shear, shears, style, woman, роХроЯрпН, роХрпКро│рпНро│рпБроорпН, родро▓рпИроорпБроЯро┐, рокро╛ро░рпНро▓ро░рпН, рокрпЖрогрпН, роорпБроЯро┐, ро╡рпЖроЯрпНроЯро┐роХрпН, ро╣рпЗро░рпН
ЁЯТЗтАНтЩВя╕П	barber, beauty, chop, cosmetology, cut, getting, groom, hair, haircut, man, parlor, person, shear, shears, style, роЕро┤роХрпБ, роЖрогрпН, роХроЯрпН, роХрпКро│рпНро│рпБроорпН, родро▓рпИроорпБроЯро┐, роирокро░рпН, роиро┐ро▓рпИропроорпН, рокро╛ро░рпНро▓ро░рпН, роорпБроЯро┐, ро╡рпЖроЯрпНроЯро┐роХрпН, ро╡рпЖроЯрпНроЯрпБродро▓рпН, ро╣рпЗро░рпН
ЁЯТИ	barber, cut, fresh, haircut, pole, shave, роГрокрпЛро▓рпН, роХроЯрпИ, рокро╛ро░рпНрокро░рпН, рокрпЛро▓рпН, роорпБроЯро┐родро┐ро░рпБродрпНродроХроорпН, роорпБроЯро┐родро┐ро░рпБродрпНродрпБродро▓рпН, роорпБроЯро┐родро┐ро░рпБродрпНродрпБрокро╡ро░рпН, роорпБроЯро┐родро┐ро░рпБродрпНродрпБроорпН, роорпБроЯро┐ро╡рпЖроЯрпНроЯрпБроорпН
ЁЯТЙ	doctor, flu, medicine, needle, shot, sick, syringe, tool, vaccination, роКроЪро┐, роХро╛ропрпНроЪрпНроЪро▓рпН, роЪро┐роХро┐роЪрпНроЪрпИ, роЪро┐ро░ро┐роЮрпНроЪрпБ, родроЯрпБрокрпНрокрпВроЪро┐, рокрпКро░рпБро│рпН, рооро░рпБродрпНродрпБро╡роорпН, рооро░рпБроирпНродрпБ, ро╡рпИродрпНродро┐ропроорпН
ЁЯТК	doctor, drug, drugs, medicated, medicine, pill, pills, sick, vitamin, роЙроЯро▓рпН, роХро╛ропрпНроЪрпНроЪро▓рпН, роХрпБро▒рпИро╡рпБ, роХрпЗрокрпНро╕рпНропрпВро▓рпН, роиро▓роХрпН, рокрпКро░рпБро│рпН, рооро░рпБродрпНродрпБро╡роорпН, рооро░рпБродрпНродрпБро╡ро░рпН, рооро░рпБроирпНродрпБ, рооро╛родрпНродро┐ро░рпИ, ро╡рпИроЯрпНроЯрооро┐ройрпН
ЁЯТН	diamond, engaged, engagement, married, ring, romance, shiny, sparkling, wedding, роЕрогро┐роХро▓ройрпН, роХро╛родро▓рпН, родро┐ро░рпБроорогроорпН, роиро┐роЪрпНроЪропродрпНродро╛ро░рпНродрпНродроорпН, роорпЛродро┐ро░роорпН, ро░рпКрооро╛ройрпНро╕рпН, ро╡рпИро░роорпН
ЁЯТО	diamond, engagement, gem, jewel, money, romance, stone, wedding, роЖрокро░рогроорпН, роХро▓рпН, роХро╛родро▓рпН, роироХрпИ, ро░родрпНродро┐ройроХрпН, ро░родрпНродро┐ройроорпН, ро░ро╛роЪро┐, ро░ро╛роЪро┐роХрпНроХро▓рпН, ро╡рпИро░роорпН
ЁЯТР	anniversary, birthday, bouquet, date, flower, love, plant, romance, роХро╛родро▓рпН, рокро┐ро▒роирпНродроиро╛ро│рпН, рокрпВроЩрпНроХрпКродрпНродрпБ, рооро▓ро░рпНроХро│рпН, рооро▓ро░рпНроХрпНроХрпКродрпНродрпБ, ро░рпКрооро╛ройрпНро╕рпН, ро╡ро╛ро┤рпНродрпНродрпБ
ЁЯТТ	chapel, hitched, nuptial, nuptials, romance, wedding, роЕро░роЩрпНроХрпБ, роХро▓рпНропро╛рогроорпН, роХро╛родро▓рпН, родро┐ро░рпБроорог, родро┐ро░рпБроорогроорпН, родрпЗро╡ро╛ро▓ропроорпН, ро░рпКрооро╛ройрпНро╕рпН
ЁЯТб	bulb, comic, electric, idea, light, роРроЯро┐ропро╛, роТро│ро┐, роХрпБрогрпНроЯрпБ, роХрпБрооро┐ро┤рпН, роироХрпИроЪрпНроЪрпБро╡рпИ, рокро▓рпНрокрпБ, рооро┐ройрпНроЪро╛ро░роорпН, рооро┐ройрпНро╡ро┐ро│роХрпНроХрпБ, ропрпЛроЪройрпИ
ЁЯТгя╕П	bomb, boom, comic, dangerou, dangerous, explosion, hot, роХрпБрогрпНроЯрпБ, роХрпБрогрпНроЯрпБро╡рпЖроЯро┐рокрпНрокрпБ, рокро╛роорпН, ро╡рпЖроЯро┐роХрпБрогрпНроЯрпБ, ро╡рпЖроЯро┐рокрпКро░рпБро│рпН
ЁЯТз	cold, comic, drop, droplet, nature, sad, sweat, tear, water, weather, роХрпБро│ро┐ро░рпН, родрогрпНрогрпАро░рпН, родрпБро│ро┐, роирпАро░рпН, ро╡ро┐ропро░рпНро╡рпИ, ро╡ро┐ропро░рпНро╡рпИродрпНродрпБро│ро┐, ро╡рпЖропро┐ро▓рпН
ЁЯТо	flower, white, роЕро░рпБроорпИ, роОройрпНрокродрпИроХрпН, роХрпБро▒ро┐роХрпНроХрпБроорпН, рокрпВ, рооро▓ро░рпН, роорпБродрпНродро┐ро░рпИ, ро╡рпЖро│рпНро│рпИ, ро╡рпЖро│рпНро│рпИроиро┐ро▒рокрпН
ЁЯТ░я╕П	bag, bank, bet, billion, cash, cost, dollar, gold, million, money, moneybag, paid, paying, pot, rich, win, роЪрпБро░рпБроХрпНроХрпБрокрпНрокрпИ, роЯро╛ро▓ро░рпН, рокрогроХрпНроХро╛ро░ро░рпН, рокрогрокрпНрокрпИ, рокрогроорпН, рокрпБродрпИропро▓рпН, рокрпКро░рпБро│рпН, ро╡роЩрпНроХро┐
ЁЯТ│я╕П	bank, card, cash, charge, credit, money, pay, роЕроЯрпНроЯрпИ, роХроЯройрпН, роХроЯрпНроЯрогроорпН, роХро╛ро░рпНроЯрпБ, роХро┐ро░рпЖроЯро┐роЯрпН, роЪрпЖро▓рпБродрпНродрпБ, рокрогроорпН, рокрпКро░рпБро│рпН, ро╖ро╛рокрпНрокро┐роЩрпН
ЁЯТ┤	bank, banknote, bill, currency, money, note, yen, роХроЯрпНроЯрпБ, роЬрокрпНрокро╛ройрпН, роирпЛроЯрпНроЯрпБ, роирпЛроЯрпНроЯрпБроХрпН, рокрогроорпН, рокрпКро░рпБро│рпН, ропрпЖройрпН, ро░рпВрокро╛ропрпН
ЁЯТ╡	bank, banknote, bill, currency, dollar, money, note, роЕроорпЖро░ро┐роХрпНроХро╛, роХроЯрпНроЯрпБ, роХро░ройрпНроЪро┐, роХро░ройрпНро╕ро┐, роЯро╛ро▓ро░рпН, роиро╛рогропроорпН, роирпЛроЯрпНроЯрпБ, роирпЛроЯрпНроЯрпБроХрпН, рокрогроорпН, роорогро┐, ро╡роЩрпНроХро┐
ЁЯТ╢	100, bank, banknote, bill, currency, euro, money, note, rich, роРро░рпЛрокрпНрокро╛, роХроЯрпНроЯрпБ, роирпЛроЯрпНроЯрпБ, роирпЛроЯрпНроЯрпБроХрпН, рокрогроорпН, ропрпВро░рпЛ, ро░рпВрокро╛ропрпН
ЁЯТ╖	bank, banknote, bill, billion, cash, currency, money, note, pound, pounds, роЗроЩрпНроХро┐ро▓ро╛роирпНродрпБ, роХроЯрпНроЯрпБ, роХро░ройрпНроЪро┐, роирпЛроЯрпНроЯрпБ, роирпЛроЯрпНроЯрпБроХрпН, рокрогроорпН, рокро╡рпБрогрпНроЯрпН, ро░рпВрокро╛ропрпН, ро╡роЩрпНроХро┐
ЁЯТ╕	bank, banknote, bill, billion, cash, dollar, fly, million, money, note, pay, wing, wings, роЗро▒роХрпНроХрпИроХро│рпБроЯройрпН, роХрпВроЯро┐роп, рокрогроорпН, рокро▒роХрпНроХрпБроорпН, ро╡роЩрпНроХро┐, ро╡роЩрпНроХро┐рокрпН
ЁЯТ╣	bank, chart, currency, graph, growth, increasing, market, money, rise, trend, upward, yen, роПро▒рпБроорпБроХроорпН, роПро▒рпНро▒роорпН, роХро░ройрпНроЪро┐, роЪроирпНродрпИ, рокроЩрпНроХрпБроЪрпНроЪроирпНродрпИ, рокрпЛроХрпНроХрпБ, ропрпЖройрпН, ро╡ро│ро░рпБроорпН, ро╡ро│ро░рпНроЪрпНроЪро┐
ЁЯТ║	chair, seat, роЗро░рпБроХрпНроХрпИ, роЪрпАроЯрпН, роиро╛ро▒рпНроХро╛ро▓ро┐
ЁЯТ╗я╕П	computer, laptop, office, pc, personal, роЖрокро┐ро╕рпН, роХрогро┐ройро┐, роХрогро┐рокрпНрокрпКро▒ро┐, родройро┐роирокро░рпН, рокро░рпНроЪройро▓рпН, рокро┐роЪро┐, ро▓рпЗрокрпНроЯро╛рокрпН
ЁЯТ╝	briefcase, office, роЕро▓рпБро╡ро▓роХроорпН, роЖро╡рогроорпН, роХрпЗро╕рпН, роЪрпВроЯрпНроХрпЗро╕рпН, рокрпЖроЯрпНроЯро┐, рокрпКро░рпБро│рпН, рокрпНро░рпАроГрокрпН, ро▓рпЗрокрпНроЯро╛рокрпН
ЁЯТ╜	computer, disk, minidisk, optical, роЖрокрпНроЯро┐роХро▓рпН, роХрогро┐ройро┐, роХроорпНрокрпНропрпВроЯрпНроЯро░рпН, роЯро┐ро╕рпНроХрпН, рооро┐ройро┐, ро╡роЯрпНроЯрпБ
ЁЯТ╛	computer, disk, floppy, роГрокро┐ро│ро╛рокрпНрокро┐, роГрокрпНро│ро╛рокрпНрокро┐, роХрогро┐ройро┐, роХроорпНрокрпНропрпВроЯрпНроЯро░рпН, роЪрпЗрооро┐рокрпНрокрпБ, роЯро┐ро╕рпНроХрпН, рокро┐ро│ро╛рокрпНрокро┐
ЁЯТ┐я╕П	blu, cd, computer, disk, dvd, optical, ray, роЖрокрпНроЯро┐роХро▓рпН, роЪро┐роЯро┐, роЯро┐ро╡ро┐роЯро┐, роЯро┐ро╕рпНроХрпН, рокрпНро│рпВ, ро░рпЗ, ро╡роЯрпНроЯрпБ
ЁЯУА	blu, cd, computer, disk, dvd, optical, ray, роЖрокрпНроЯро┐роХро▓рпН, роХроорпНрокрпНропрпВроЯрпНроЯро░рпН, роЪро┐роЯро┐, роЯро┐ро╡ро┐роЯро┐, роЯро┐ро╕рпНроХрпН, рокрпКро░рпБро│рпН, рокрпНро│рпВ, ро░рпЗ, ро╡роЯрпНроЯрпБ
ЁЯУБ	file, folder, роГрокрпИро▓рпН, роГрокрпЛро▓рпНроЯро░рпН, роЖро╡рогроорпН, роХро╛роХро┐родроорпН, роХрпЛрокрпНрокроХроорпН, роХрпЛрокрпНрокрпБ, рокрпИро▓рпН, рокрпКро░рпБро│рпН
ЁЯУВ	file, folder, open, роГрокрпИро▓рпН, роГрокрпЛро▓рпНроЯро░рпН, роУрокрпНрокройрпН, родро┐ро▒роирпНрод, родро┐ро▒роирпНродрпБ, рокрпИро▓рпН, рокрпКро░рпБро│рпН
ЁЯУГ	curl, document, page, paper, роЖро╡рогроорпН, роХрпАро┤рпЗ, роЪрпБро░рпБроЯрпНроЯро┐роп, роЪрпБро░рпБрогрпНроЯ, роЪрпБро░рпБро│рпН, рокроХрпНроХроЪрпН, рокроХрпНроХроорпН, рокрпКро░рпБро│рпН
ЁЯУД	document, facing, page, paper, up, роЖро╡рогроорпН, роХроЯро┐родроорпН, роХро╛роХро┐родроорпН, родро╛ро│рпН, родро┐ро▒роирпНрод, роирпЗро░рпН, рокрпЗрокрпНрокро░рпН
ЁЯУЕ	calendar, date, роХро╛ро▓рогрпНроЯро░рпН, роХро╛ро▓рпЗрогрпНроЯро░рпН, родро┐ройроХрпН, родро┐ройроЪро░ро┐, роиро╛роЯрпНроХро╛роЯрпНроЯро┐, роиро╛ро│рпНроХро╛роЯрпНроЯро┐, рокрпКро░рпБро│рпН
ЁЯУЖ	calendar, off, tear, роХро╛ро▓рогрпНроЯро░рпН, роХро╛ро▓рпЗрогрпНроЯро░рпН, роХро┐ро┤ро┐роХрпНроХрпБроорпН, роХро┐ро┤ро┐родрпНродро▓рпН, родро┐ройроЪро░ро┐, родрпЗродро┐, родрпЗродро┐ропрпИроХрпН, роиро╛роЯрпНроХро╛роЯрпНроЯро┐, роиро╛ро│рпНроХро╛роЯрпНроЯро┐, рокрпКро░рпБро│рпН
ЁЯУЗ	card, index, old, rolodex, school, роЕроЯрпНроЯро╡рогрпИ, роЕроЯрпНроЯрпИ, роЗройрпНроЯрпЖроХрпНро╕рпН, роОрогрпН, роХро╛ро░рпНроЯрпБ, рокрпЗрокрпНрокро░рпН, рокрпКро░рпБро│рпН, ро░рпЛро▓ро┐роЩрпН, ро╡ро░ро┐роЪрпИ
ЁЯУИ	chart, data, graph, growth, increasing, right, trend, up, upward, роКроХрпНроХроорпН, роПро▒рпНро▒роорпН, роЪро╛ро░рпНроЯрпН, роЪрпЖро▓рпНро▓рпБродро▓рпН, роЯро┐ро░рпЖрогрпНроЯрпН, родро░ро╡рпБ, роирпЛроХрпНроХро┐, рокроЩрпНроХрпБ, роорпЗро▓рпН, ро╡ро░рпИрокроЯроорпН, ро╡ро│ро░рпНроЪрпНроЪро┐
ЁЯУЙ	chart, data, decreasing, down, downward, graph, negative, trend, роЯро┐ро░рпЖрогрпНроЯрпН, родро░ро╡рпБ, родро╛ро┤рпНро╡рпБ, рокроЩрпНроХрпБ, рокрпЛроХрпНроХрпБ, ро╡ро░рпИрокроЯроорпН, ро╡рпАро┤рпНроЪрпНроЪро┐, ро╡рпАро┤рпНродро▓рпН
ЁЯУК	bar, chart, data, graph, роХро┐ро░ро╛роГрокрпН, роХро┐ро░ро╛рокрпН, роЪро╛ро░рпНроЯрпН, рокроЯрпНроЯрпИ, рокро╛ро░рпН, ро╡ро░рпИрокроЯроорпН
ЁЯУЛя╕П	clipboard, do, list, note, notes, роЕроЯрпНроЯрпИ, роХро┐ро│ро┐рокрпН, роХрпБро▒ро┐рокрпНрокрпБ, роЪрпЖропро▓рпН, рокроЯрпНроЯро┐ропро▓рпН, рокро░рпАроЯрпНроЪрпИ, рокрпКро░рпБро│рпН, рокрпЛро░рпНроЯрпБ
ЁЯУМ	collage, pin, pushpin, роКроЪро┐, роХрпБродрпНродрпБ, роХрпБро▒ро┐рокрпНрокрпБ, роХрпКро▓рпНро▓ро╛роЬрпН, рокро┐ройрпН, рокрпБро╖рпН
ЁЯУН	location, map, pin, pushpin, round, роЗроЯроорпН, роЗро░рпБрокрпНрокро┐роЯроорпН, роХрпБрогрпНроЯрпВроЪро┐, роХрпБро▒ро┐, рокро┐ройрпН, рокрпБро╖рпНрокро┐ройрпН, ро╡роЯрпНроЯ, ро╡ро░рпИрокроЯроХрпН
ЁЯУО	paperclip, роХро┐ро│ро┐рокрпН, роЬрпЖроорпН, рокрпЖрокрпНрокро░рпН, рокрпЗрокрпНрокро░рпН
ЁЯУП	angle, edge, math, ruler, straight, straightedge, роЕроЯро┐ро╕рпНроХрпЗро▓рпН, роЕро│ро╡рпАроЯрпБ, роЕро│ро╡рпБ, роЕро│ро╡рпБроХрпЛро▓рпН, роХрогро┐родроорпН, роХрпЛроЯрпБ, роХрпЛрогроорпН, рокрпКро░рпБро│рпН, ро░рпВро▓ро░рпН, ро╕рпНроХрпЗро▓рпН
ЁЯУР	angle, math, rule, ruler, set, slide, triangle, triangular, роЕро│ро╡рпБроХрпЛро▓рпН, роХрпЛрогроорпН, роЪрпЖроЯрпН, роорпБроХрпНроХрпЛрогрооро╛ройро┐, роорпБроХрпНроХрпЛрогроорпН, ро╕рпНроХрпКропро░рпН
ЁЯУС	bookmark, mark, marker, tab, tabs, роХрпБро▒ро┐родрпНродро▓рпН, роЯрпЗрокрпНро╕рпН, рокрпБроХрпНрооро╛ро░рпНроХрпН, рокрпБродрпНродроХроХрпНроХрпБро▒ро┐, рокрпБродрпНродроХродрпНродро┐ро▓рпН, рокрпКро░рпБро│рпН, рооро╛ро░рпНроХрпНроХро░рпН
ЁЯУТ	ledger, notebook, роЯропро░ро┐, роирпЛроЯрпНроЯрпБ, роирпЛроЯрпНроЯрпБрокрпНрокрпБродрпНродроХроорпН, рокрпБродрпНродроХроорпН, ро▓рпЖроЯрпНроЬрпЖро░рпН
ЁЯУУ	notebook, роХро▓рпНро╡ро┐, роирпЛроЯрпНроЯрпБ, роирпЛроЯрпНроЯрпБрокрпНрокрпБродрпНродроХроорпН, роирпЛроЯрпНрокрпБроХрпН, рокроЯро┐рокрпНрокрпБ, рокрпБроХрпН, рокрпБродрпНродроХроорпН, рокрпКро░рпБро│рпН
ЁЯУФ	book, cover, decorated, decorative, education, notebook, school, writing, роЕроЯрпНроЯрпИ, роЕро┤роХро╛рой, роОро┤рпБродрпНродрпБ, роХро╡ро░рпН, роирпЛроЯрпНроЯрпБ, роирпЛроЯрпНрокрпБроХрпН, рокро│рпНро│ро┐, рокрпБродрпНродроХроорпН, рокрпКро░рпБро│рпН, рокрпЛроЯрокрпНрокроЯрпНроЯ, ро╡роХрпБрокрпНрокрпБ, ро╡рпЗро▓рпИрокрпНрокро╛роЯро╛рой
ЁЯУХ	book, closed, education, роХро▓рпНро▓рпВро░ро┐, роиро╛ро╡ро▓рпН, рокро│рпНро│ро┐, рокрпБродрпНродроХроорпН, рокрпКро░рпБро│рпН, роорпВроЯро┐роп, ро╡ро╛роЪро┐рокрпНрокрпБ
ЁЯУЦ	book, education, fantasy, knowledge, library, novel, novels, open, reading, роЕро▒ро┐ро╡рпБ, роХро▓рпНро▓рпВро░ро┐, роХро▓рпНро╡ро┐, родро┐ро▒роирпНрод, роиро╛ро╡ро▓рпН, рокроЯро┐рокрпНрокрпБ, рокро│рпНро│ро┐, рокрпБроХрпН, рокрпБродрпНродроХроорпН, рокрпКро░рпБро│рпН, ро╡ро╛роЪро┐рокрпНрокрпБ
ЁЯУЧ	book, education, fantasy, green, library, reading, роХро▓рпНро▓рпВро░ро┐, роХро▓рпНро╡ро┐, роиро╛ро╡ро▓рпН, роирпВро▓роХроорпН, рокроЪрпНроЪрпИ, рокро│рпНро│ро┐, рокрпБроХрпН, рокрпБродрпНродроХроорпН, рокрпКро░рпБро│рпН, ро▓рпИрокрпНро░ро░ро┐, ро╡ро╛роЪро┐рокрпНрокрпБ
ЁЯУШ	blue, book, education, fantasy, library, reading, роХро▓рпНро╡ро┐, роирпАро▓рокрпН, роирпВро▓роХроорпН, рокроЯро┐рокрпНрокрпБ, рокро│рпНро│ро┐, рокрпБродрпНродроХроорпН, рокрпКро░рпБро│рпН, ро▓рпИрокрпНро░ро░ро┐, ро╡ро╛роЪро┐рокрпНрокрпБ
ЁЯУЩ	book, education, fantasy, library, orange, reading, роЖро░роЮрпНроЪрпБ, роХро▓рпНро╡ро┐, роирпВро▓роХроорпН, рокроЯро┐рокрпНрокрпБ, рокрпБродрпНродроХроорпН, рокрпКро░рпБро│рпН, ро▓рпИрокрпНро░ро░ро┐, ро╡ро╛роЪро┐рокрпНрокрпБ
ЁЯУЪя╕П	book, books, education, fantasy, knowledge, library, novel, novels, reading, school, study, роЕро▒ро┐ро╡рпБ, роХро▓рпНро▓рпВро░ро┐, роХро▓рпНро╡ро┐, роирпВро▓роХроорпН, рокроЯро┐рокрпНрокрпБ, рокро│рпНро│ро┐, рокрпБродрпНродроХроЩрпНроХро│рпН, рокрпБродрпНродроХроорпН, ро▓рпИрокрпНро░ро░ро┐, ро╡ро╛роЪро┐рокрпНрокрпБ
ЁЯУЬ	paper, scroll, роОро┤рпБродрпНродрпБ, роУро▓рпИ, роХроЯро┐родроорпН, роЪрпБро░рпБроЯрпНроЯрпБ, роЪрпБро░рпБро│рпН, родроХро╡ро▓рпН, родрпКроЯро░рпНрокрпБ, рокрпЗрокрпНрокро░рпИ, рокрпКро░рпБро│рпН, ро╕рпНроХрпНро░рпЛро▓рпН
ЁЯУЭ	communication, media, memo, note, notes, pencil, роХроЯро┐родроорпН, роХрпБро▒ро┐рокрпНрокрпБ, роХрпБро▒ро┐рокрпНрокрпБрокрпН, родроХро╡ро▓рпН, родрпКроЯро░рпНрокрпБ, роирпЛроЯрпН, рокрпБродрпНродроХроорпН, рокрпЖройрпНроЪро┐ро▓рпН, рокрпКро░рпБро│рпН, роорпАроЯро┐ропро╛, роорпЖроорпЛ
ЁЯУЮ	communication, phone, receiver, telephone, voip, роЕро┤рпИ, роЕро┤рпИрокрпНрокрпБ, роЯрпЖро▓ро┐рокрпЛройрпН, родроХро╡ро▓рпН, родрпКроЯро░рпНрокрпБ, родрпКроЯро░рпНрокрпБроХрпКро│рпН, родрпКро▓рпИрокрпЗроЪро┐, рокрпКро░рпБро│рпН, ро░ро┐роЪрпАро╡ро░рпН
ЁЯУЯя╕П	communication, pager, роЪрпЖропрпНродро┐, родроХро╡ро▓рпН, родрпКроЯро░рпНрокрпБ, рокрпЗроЬро░рпН, рокрпКро░рпБро│рпН
ЁЯУа	communication, fax, machine, роГрокрпЗроХрпНро╕рпН, роЗропроирпНродро┐ро░роорпН, родроХро╡ро▓рпН, родрпКроЯро░рпНрокрпБ, родрпКроЯро░рпНрокрпБроХрпКро│рпН, родрпКро▓рпИроироХро▓ро┐, родрпКро▓рпИроироХро▓рпН, рокрпЗроХрпНро╕рпН
ЁЯУб	alien, aliens, antenna, contact, dish, satellite, science, роЖрогрпНроЯрпЖройро╛, роЖройрпНроЯройро╛, роХрпЛро│рпН, роЪро╛роЯрпНроЯро┐ро▓рпИроЯрпН, роЪрпЖропро▒рпНроХрпИ, роЪрпЖропро▒рпНроХрпИроХрпНроХрпЛро│рпН, роЯро┐ро╡ро┐, роЯро┐ро╖рпН, родрпКроЯро░рпНрокрпБ
ЁЯУв	addres, address, communication, loud, loudspeaker, public, sound, роЕро▒ро┐ро╡ро┐рокрпНрокрпБ, роТро▓ро┐рокрпНрокрпЖро░рпБроХрпНроХро┐, роЪрпЖропрпНродро┐, родроХро╡ро▓рпН, родрпКроЯро░рпНрокрпБ, рокрпКродрпБ, ро▓ро╡рпБроЯрпН, ро╕рпНрокрпАроХрпНроХро░рпН
ЁЯУг	cheering, megaphone, sound, роЙро▒рпНроЪро╛роХроорпН, роХрпВро╡рпБродро▓рпН, роЪро┐ропро░ро┐роЩрпН, родрпКроЯро░рпНрокрпБ, роорпЖроХро╛рокрпЛройрпН
ЁЯУдя╕П	box, email, letter, mail, outbox, sent, tray, роЕроЮрпНроЪро▓рпН, роЕройрпБрокрпНрокрокрпНрокроЯрпНроЯродрпБ, роЕро╡рпБроЯрпНрокро╛роХрпНро╕рпН, роХроЯро┐родроорпН, родроЯрпНроЯрпБ, рокрпЖроЯрпНроЯро┐, рооро┐ройрпНройроЮрпНроЪро▓рпН
ЁЯУея╕П	box, email, inbox, letter, mail, receive, tray, zero, роЕроЮрпНроЪро▓рпН, роЗройрпНрокро╛роХрпНро╕рпН, родроЯрпНроЯрпБ, рокрпЖроЯрпНроЯро┐, рокрпЖро▒рпБродро▓рпН
ЁЯУжя╕П	box, communication, delivery, package, parcel, shipping, роЯрпЖро▓ро┐ро╡ро░ро┐, рокро╛роХрпНро╕рпН, рокро╛ро░рпНроЪро▓рпН, рокрпЖроЯрпНроЯро┐, рокрпЗроХрпН, рокрпЗроХрпНроХрпЗроЬрпН, рокрпКро░рпБро│рпН, ро╖ро┐рокрпНрокро┐роЩрпН
ЁЯУз	email, letter, mail, роЕроЮрпНроЪро▓рпН, роЗроорпЖропро┐ро▓рпН, роИроорпЖропро┐ро▓рпН, роХроЯро┐родроорпН, роЪро┐ройрпНройроорпН, роЪро┐роорпНрокро▓рпН, родроХро╡ро▓рпН, родрпКроЯро░рпНрокрпБ, рооро┐ройрпН, рооро┐ройрпНройроЮрпНроЪро▓рпН
ЁЯУи	delivering, email, envelope, incoming, letter, mail, receive, sent, роЕроЮрпНроЪро▓рпН, роЙро▒рпИ, роХроЯро┐род, роХроЯро┐родроорпН, рокрпЖро▒рокрпНрокроЯрпНроЯ, рокрпЖро▒рпНро▒, рооро┐ройрпНройроЮрпНроЪро▓рпН, рооро┐ройрпНройрогрпБ, роорпЖропро┐ро▓рпН, ро╡роирпНрод
ЁЯУй	arrow, communication, down, email, envelope, letter, mail, outgoing, send, sent, роЕроЮрпНроЪро▓рпН, роЕройрпБрокрпНрокрокрпНрокроЯрпНроЯродрпБ, роЕройрпБрокрпНрокро┐роп, роЕроорпНрокрпБроХрпНроХрпБро▒ро┐ропрпБроЯройрпН, роЙро▒рпИ, роХроЯро┐род, роХроЯро┐родроорпН, родроХро╡ро▓рпН, родрпКроЯро░рпНрокрпБ, рокрпЛрой, рооро┐ройрпНройроЮрпНроЪро▓рпН, рооро┐ройрпНройрогрпБ, роорпЖропро┐ро▓рпН, ро╡рпЖро│ро┐роЪрпНроЪрпЖро▓рпНро▓рпБроорпН
ЁЯУкя╕П	closed, flag, lowered, mail, mailbox, postbox, роЕроЮрпНроЪро▓рпН, роЗро▓рпНро▓рпИ, роОродрпБро╡рпБрооро┐ро▓рпНро▓ро╛род, роХроЯро┐родроорпН, роХрпКроЯро┐, роЪро╛ропрпНроирпНрод, родрокро╛ро▓рпН, рокрпЖроЯрпНроЯро┐, роорпВроЯро┐ропродрпБ
ЁЯУля╕П	closed, communication, flag, mail, mailbox, postbox, raised, роЕроЮрпНроЪро▓рпН, роЗро░рпБрокрпНрокродрпИроХрпН, роХро╛роЯрпНроЯрпБроорпН, роХрпКроЯро┐рокро▒роХрпНроХрпБроорпН, родрокро╛ро▓рпН, рокро╛роХрпНро╕рпН, рокрпЖроЯрпНроЯро┐, роорпВроЯро┐роп, роорпЖропро┐ро▓рпН
ЁЯУмя╕П	flag, mail, mailbox, open, postbox, raised, роЕроЮрпНроЪро▓рпБроЯройрпН, роЕроЮрпНроЪро▓рпН, роЗро░рпБроХрпНроХрпБроорпН, роХроЯро┐родроорпН, роХрпКроЯро┐рокро▒роХрпНроХрпБроорпН, родрокро╛ро▓рпН, родро┐ро▒роХрпНроХрокрпНрокроЯрпНроЯ, родро┐ро▒роирпНрод, роиро┐ро▓рпИропро┐ро▓рпН, рокро╛роХрпНро╕рпН, рокрпЖроЯрпНроЯро┐, рокрпКро░рпБро│рпН, роорпЖропро┐ро▓рпН
ЁЯУня╕П	flag, lowered, mail, mailbox, open, postbox, роЕроЮрпНроЪро▓рпН, роЗро░рпБроХрпНроХрпБроорпН, роОродрпБро╡рпБрооро┐ро▓рпНро▓ро╛род, роХрпКроЯро┐роЪро╛ропрпНроирпНрод, родрокро╛ро▓рпН, родро┐ро▒роирпНрод, роиро┐ро▓рпИропро┐ро▓рпН, рокро╛роХрпНро╕рпН, рокрпЖроЯрпНроЯро┐, рокрпКро░рпБро│рпН, роорпЖропро┐ро▓рпН
ЁЯУо	mail, mailbox, postbox, роЕроЮрпНроЪро▓рпН, роХроЯро┐родроорпН, родрокро╛ро▓рпН, рокрпЖроЯрпНроЯро┐, рокрпКро░рпБро│рпН, рокрпЛро╕рпНроЯрпН, рокрпЛро╕рпНроЯрпНрокро╛роХрпНро╕рпН, роорпЖропро┐ро▓рпН
ЁЯУп	horn, post, postal, рокрпКро░рпБро│рпН, рокрпЛро╕рпНроЯро▓рпН, ро╣ро╛ро░рпНройрпН
ЁЯУ░	communication, new, news, newspaper, paper, роЪрпЖропрпНродро┐роХро│рпН, роЪрпЖропрпНродро┐родрпНродро╛ро│рпН, роиро╛ро│рпЗроЯрпБ, роиро┐ропрпВро╕рпН, рокрпЗрокрпНрокро░рпН, рокрпКро░рпБро│рпН
ЁЯУ▒	cell, communication, mobile, phone, telephone, роГрокрпЛройрпН, роЪрпЖро▓рпН, роЪрпЖро▓рпНрокрпЗроЪро┐, роЪрпЖро▓рпНрокрпЛройрпН, родроХро╡ро▓рпН, родрпКроЯро░рпНрокрпБ, рокрпКро░рпБро│рпН, роорпКрокрпИро▓рпН
ЁЯУ▓	arrow, build, call, cell, communication, mobile, phone, receive, telephone, роГрокрпЛройрпН, роЕроорпНрокрпБроХрпНроХрпБро▒ро┐, роЕроорпНрокрпБроХрпНроХрпБро▒ро┐ропрпБроЯройрпН, роЕро┤рпИ, роЕро┤рпИрокрпНрокрпБ, роЪрпЖро▓рпНроГрокрпЛройрпН, роЪрпЖро▓рпНрокрпЛройрпН, родроХро╡ро▓рпН, родрпКроЯро░рпНрокрпБ, рокрпЖро▒рпБродро▓рпН, рокрпКро░рпБро│рпН, роорпКрокрпИро▓рпН
ЁЯУ╖я╕П	camera, photo, selfie, snap, tbt, trip, video, роЗройрпНро╕рпНроЯро╛роХро┐ро░ро╛роорпН, роХрпЗрооро░ро╛, роиро┐ройрпИро╡рпБ, рокроЯроорпН, рокрпБроХрпИрокрпНрокроЯроорпН, рокрпКро░рпБро│рпН, ро╡рпАроЯро┐ропрпЛ, ро╕рпНройро╛рокрпН
ЁЯУ╕	camera, flash, video, роГрокро┐ро│ро╛ро╖рпН, роГрокрпНро│ро╛ро╖рпН, роЕроЯро┐роХрпНроХрпБроорпН, роХрпЗрооро░ро╛, рокро┐ро│ро╛ро╖рпН, ро╡рпАроЯро┐ропрпЛ
ЁЯУ╣я╕П	camcorder, camera, tbt, video, роХро╛роорпН, роХро╛ро░рпНроЯро░рпН, роХрпЗрооро░ро╛, роХрпЗроорпН, роЯро┐рокро┐роЯро┐, ро╡рпАроЯро┐ропрпЛ
ЁЯУ║я╕П	television, tv, video, роЪрпАро░ро┐ропро▓рпН, роЯро┐ро╡ро┐, роЯрпЖро▓ро┐ро╡ро┐ро╖ройрпН, родро┐ро░рпИрокрпНрокроЯроорпН, родрпКро▓рпИроХрпНроХро╛роЯрпНроЪро┐
ЁЯУ╗я╕П	entertainment, radio, tbt, video, роОроГрокрпН, роОрокрпНроОроорпН, роОроорпН, роХрпЗро░ро╡ройрпН, роЪрпЖропрпНродро┐, рокро╛роЯро▓рпН, рокро╛роЯрпНроЯрпБ, ро░рпЗроЯро┐ропрпЛ, ро╡ро╛ройрпКро▓ро┐
ЁЯУ╝	old, school, tape, vcr, vhs, video, videocassette, роХрпЗроЪроЯрпН, роХрпЗро╕роЯрпН, роЯрпЗрокрпН, роиро┐ройрпИро╡рпБроХро│рпН, рокро┤рпИроп, ро╡ро┐ро╣рпЖроЪрпНроОро╕рпН, ро╡рпАроЯро┐ропрпЛ
ЁЯУ┐	bead, beads, clothing, necklace, prayer, religion, роЕрогро┐роХро▓ройрпН, роЙроЯрпИ, роЬрпЖрокрооро╛ро▓рпИ, роЬрпЖрокроорпН, роирпЖроХрпНро▓ро╕рпН, рокропройрпНрокроЯрпБроорпН, рокро╛роЪро┐роорогро┐роХро│рпН, рокро┐ро░ро╛ро░рпНродрпНродройрпИ, рокро┐ро░ро╛ро░рпНродрпНродройрпИроХрпНроХро╛рой, рокрпКро░рпБро│рпН, роорогро┐роХро│рпН, роородроорпН, рооро╛ро▓рпИ, ро╡ро┤ро┐рокроЯрпБро╡родро▒рпНроХрпБрокрпН
ЁЯФЗ	mute, muted, quiet, silent, sound, speaker, роЕрогрпИ, роЕроорпИродро┐, роЖроГрокрпН, роТро▓ро┐ропроЯроХрпНроХрпБ, роТро▓ро┐ропрпИ, роЪрпИро▓ройрпНро╕рпН, роиро┐роЪрокрпНродроорпН, рокрпКро░рпБро│рпН, ро╕рпНрокрпАроХрпНроХро░рпН
ЁЯФИя╕П	low, soft, sound, speaker, volume, роЗро░рпИроЪрпНроЪро▓рпН, роТро▓ро┐, роТро▓ро┐рокрпНрокрпЖро░рпБроХрпНроХро┐, роХрпБро▒рпИроирпНрод, роЪродрпНродроорпН, роЪро╡рпБрогрпНроЯрпН, рокрпЗроЪрпБ, рокрпКро░рпБро│рпН, ро╕рпНрокрпАроХрпНроХро░рпН
ЁЯФЙ	medium, sound, speaker, volume, роЖройрпН, роТро▓ро┐, роТро▓ро┐рокрпНрокрпЖро░рпБроХрпНроХро┐, роХрпБро▒рпИроирпНрод, роЪро╡рпБрогрпНроЯрпН, роироЯрпБродрпНродро░, рокрпЗроЪрпБ, рокрпКро░рпБро│рпН, роорпЖродрпБро╡ро╛роХ, ро╕рпНрокрпАроХрпНроХро░рпН
ЁЯФК	high, loud, music, sound, speaker, volume, роЕро▓ро▒рпБроорпН, роЗро░рпИроЪрпНроЪро▓рпН, роЪродрпНродрооро╛роХрокрпН, роЪро╡рпБрогрпНроЯрпН, рокрпЗроЪрпБ, рокрпКро░рпБро│рпН, ро╕рпНрокрпАроХрпНроХро░рпН, ро╣рпИрокро┐роЯрпНроЪрпН
ЁЯФЛ	battery, роОройро░рпНроЬро┐, рокрпЗроЯрпНроЯро░ро┐, рооро┐ройрпНроХро▓роорпН, рооро┐ройрпНроЪроХрпНродро┐
ЁЯФМ	electric, electricity, plug, рокро╛ропро┐ройрпНроЯрпН, рокро┐ройрпН, рокро┐ро│роХрпН, рокро┐ро│роХрпНроХрпБ, рооро┐ройрпНроЪро╛ро░, рооро┐ройрпНроЪро╛ро░роорпН
ЁЯФНя╕П	glas, glass, lab, left, magnifying, pointing, science, search, tilted, tool, роЕро▒ро┐ро╡ро┐ропро▓рпН, роЗроЯродрпБ, роЙро░рпБрокрпНрокрпЖро░рпБроХрпНроХро┐, роХро░рпБро╡ро┐, роЪро╛ропрпНро╡рпБ, родрпЗроЯро▓рпН, родрпЗроЯрпБ, рокрпЖро░ро┐родро╛роХрпНроХроорпН, ро▓рпЖройрпНро╕рпН
ЁЯФО	contact, glas, glass, lab, magnifying, pointing, right, science, search, tilted, tool, роЕро▒ро┐ро╡ро┐ропро▓рпН, роЖропрпНро╡рпБ, роЙро░рпБрокрпНрокрпЖро░рпБроХрпНроХро┐, роХро░рпБро╡ро┐, роЪро╛ропрпНро╡рпБ, родрпЗроЯро▓рпН, родрпЗроЯрпБ, ро▓рпЖройрпНро╕рпН, ро╡ро▓родрпБ
ЁЯФП	ink, lock, locked, nib, pen, privacy, роЕроирпНродро░роЩрпНроХроорпН, роЙро░ро┐роорпИ, роОройродрпБро░ро┐роорпИ, родройро┐ропрпБро░ро┐роорпИ, рокрпВроЯрпНроЯрпБ, рокрпЗройро╛, рокрпЗройро╛ро╡рпБроЯройрпН
ЁЯФР	bike, closed, key, lock, locked, secure, роХрпА, роЪро╛ро╡ро┐, роЪро╛ро╡ро┐ропрпБроорпН, рокро╛родрпБроХро╛роХрпНроХрокрпНрокроЯрпНроЯродрпБ, рокро╛родрпБроХро╛рокрпНрокро╛ройродрпБ, рокро╛родрпБроХро╛рокрпНрокрпБ, рокрпВроЯрпНроЯрпБ, рокрпВроЯрпНроЯрпБроорпН, рокрпКро░рпБро│рпН, роорпВроЯрокрпНрокроЯрпНроЯродрпБ, ро▓ро╛роХрпН
ЁЯФС	key, keys, lock, major, password, unlock, роХроЯро╡рпБроЪрпНроЪрпКро▓рпН, роЪро╛ро╡ро┐, родро┐ро▒, родро┐ро▒ро╡рпБроХрпЛро▓рпН, рокро╛ро╕рпНро╡рпЗро░рпНроЯрпН, рокрпВроЯрпНроЯрпБ, рокрпВроЯрпНроЯрпБродрпН, рокрпКро░рпБро│рпН
ЁЯФТя╕П	closed, lock, locked, private, роЕроирпНродро░роЩрпНроХроорпН, родройро┐рокрпНрокроЯрпНроЯродрпБ, рокрпВроЯрпНроЯро┐ропродрпБ, рокрпВроЯрпНроЯрпБ, рокрпВроЯрпНроЯрпБродро▓рпН, ро▓ро╛роХрпН
ЁЯФУя╕П	cracked, lock, open, unlock, unlocked, родро┐ро▒роХрпНроХрокрпНрокроЯрпНроЯродрпБ, родро┐ро▒роирпНрод, родро┐ро▒роирпНродродрпБ, рокрпВроЯрпНроЯро╛родродрпБ, рокрпВроЯрпНроЯрпБ, рокрпКро░рпБро│рпН
ЁЯФФ	bell, break, church, sound, роЗроЯрпИро╡рпЗро│рпИ, роТро▓ро┐, роУроЪрпИ, роХрпЛропро┐ро▓рпН, роХрпЛро╡ро┐ро▓рпН, роЪро░рпНроЪрпН, родрпЗро╡ро╛ро▓ропроорпН, рокрпЖро▓рпН, роорогро┐, роорогро┐ропрпКро▓ро┐, роорогро┐ропрпЛроЪрпИ
ЁЯФХ	bell, forbidden, mute, no, not, prohibited, quiet, silent, slash, sound, роЕроЯроХрпНроХрпБ, роЕроорпИродро┐, роТро▓ро┐, роЪродрпНродрооро┐роЯро╛родрпЗ, роЪродрпНродроорпН, родроЯрпИ, роиро┐роЪрокрпНродроорпН, рокрпЛроЯроХрпНроХрпВроЯро╛родрпБ, роорогро┐
ЁЯФЦ	bookmark, mark, роЕроЯрпИропро╛ро│роорпН, роЯрпЗроХрпН, рокроХрпНроХ, рокроЯрпНроЯро┐, рокрпБроХрпНрооро╛ро░рпНроХрпН, рокрпБродрпНродроХроХрпНроХрпБро▒ро┐, рокрпБродрпНродроХроорпН, рокрпКро░рпБро│рпН
ЁЯФЧ	link, links, роЗрогрпИ, роЗрогрпИрокрпНрокрпБ, роЗро░рпБ, роХроЯрпНроЯрпБ, роЪрпЗро░рпН, рокрпКро░рпБро│рпН, ро▓ро┐роЩрпНроХрпН, ро╡ро│рпИропроЩрпНроХро│рпН, ро╡ро│рпИропроорпН
ЁЯФе	af, burn, fire, flame, hot, lit, litaf, tool, роОро░ро┐родро▓рпН, родрпА, роирпЖро░рпБрокрпНрокрпБ
ЁЯФж	electric, flashlight, light, tool, torch, роЗро░ро╡рпБ, роЯро╛ро░рпНроЪрпН, рокро┐ро│ро╛ро╖рпН, рокрпЗроЯрпНроЯро░ро┐, рокрпКро░рпБро│рпН, ро▓рпИроЯрпН, ро╡ро┐ро│роХрпНроХрпБ, ро╡рпЖро│ро┐роЪрпНроЪроорпН
ЁЯФз	home, improvement, spanner, tool, wrench, роЗроЯрпБроХрпНроХро┐, роХро░рпБро╡ро┐, роХрпБро▒роЯрпБ, роЯрпВро▓рпН, родро┐ро░рпБроХро┐, родро┐ро░рпБроХрпБ, рокрпКро░рпБро│рпН, ро╕рпНрокрпЗройро░рпН
ЁЯФи	hammer, home, improvement, repair, repairs, tool, роЖрогро┐, роХро░рпБро╡ро┐, роЪро░ро┐роЪрпЖропрпНродро▓рпН, роЪрпБродрпНродро┐, роЪрпБродрпНродро┐ропро▓рпН, рокро┤рпБродрпБ, рокрпКро░рпБро│рпН, роорпЗроорпНрокро╛роЯрпБ, ро░ро┐рокрпНрокрпЗро░рпН, ро╡рпАроЯрпНроЯрпБ
ЁЯФй	bolt, home, improvement, nut, tool, роХро░рпБро╡ро┐, роироЯрпНроЯрпБ, роироЯрпНроЯрпБроорпН, рокрпЛро▓рпНроЯрпН, рокрпЛро▓рпНроЯрпНроЯрпБроорпН, рооро▒рпНро▒рпБроорпН
ЁЯФк	chef, cooking, hocho, kitchen, knife, tool, weapon, роЖропрпБродроорпН, роЙрогро╡рпБ, роХродрпНродро┐, роХро╛ропрпНроХро▒ро┐, роЪроорпИропро▓рпН, роЪрпЖроГрокрпН, ро╡рпЖроЯрпНроЯрпБ, ро╡рпЖроЯрпНроЯрпБродро▓рпН
ЁЯФл	gun, handgun, pistol, revolver, tool, water, weapon, роЖропрпБродроорпН, роХрпИродрпНродрпБрокрпНрокро╛роХрпНроХро┐, роЪрпБроЯрпБ, роЪрпБроЯрпБродро▓рпН, родрогрпНрогрпАро░рпН, родрпБрокрпНрокро╛роХрпНроХро┐, рокро┐ро╕рпНроЯро▓рпН, рокрпКро░рпБро│рпН, ро░ро┐ро╡ро╛ро▓рпНро╡ро░рпН
ЁЯФм	experiment, lab, microscope, science, tool, роЕро▒ро┐ро╡ро┐ропро▓рпН, роЖро░ро╛ропрпНроЪрпНроЪро┐, роХро░рпБро╡ро┐, роирпБрогрпНрогрпЛроХрпНроХро┐, рокро░ро┐роЪрпЛродройрпИ, рокрпЖро░ро┐родро╛роХрпНроХроорпН, рокрпЖро░рпБроХрпНроХро┐, рокрпКро░рпБро│рпН, роорпИроХрпНро░рпЛро╕рпНроХрпЛрокрпН
ЁЯФн	contact, extraterrestrial, science, telescope, tool, роЖро░ро╛ропрпНроЪрпНроЪро┐, роХро░рпБро╡ро┐, роХрпЛро│рпН, роЯрпЖро▓ро╕рпНроХрпЛрокрпН, родрпКро▓рпИроирпЛроХрпНроХро┐, роироЯрпНроЪродрпНродро┐ро░роорпН, рокрпКро░рпБро│рпН, ро╡ро╛ройроорпН, ро╡ро╛ройро┐ропро▓рпН, ро╡ро┐рогрпНроХро▓рпН
ЁЯФо	ball, crystal, fairy, fairytale, fantasy, fortune, future, magic, tale, tool, роХрогрпНрогро╛роЯро┐, роХро┐ро░ро┐ро╕рпНроЯро▓рпН, роХро┐ро▒ро┐ро╕рпНроЯро▓рпН, рокроирпНродрпБ, рокро╛ро▓рпН, рооро╛ропро╛роЬро╛ро▓роорпН
ЁЯХЛ	hajj, islam, kaaba, muslim, religion, umrah, роЗро╕рпНро▓ро╛рооро┐ропроорпН, роЗро╕рпНро▓ро╛роорпН, роЙроорпНро░ро╛, роХро╛рокро╛, роородроорпН, ро╣роЬрпН
ЁЯХМ	islam, masjid, mosque, muslim, religion, роЗро╕рпНро▓ро╛рооро┐ропроорпН, роЗро╕рпНро▓ро╛роорпН, роороЪрпВродро┐, роородроорпН
ЁЯХН	jew, jewish, judaism, religion, synagogue, temple, роЖро▓ропроорпН, роЬрпЖрок, роородроорпН, ропрпВрод, ропрпВродро░рпНроХро│рпН
ЁЯХРя╕П	00, clock, one, time, роЙроЪрпНроЪро┐, роТро░рпБ, роирпЗро░роорпН, роорогро┐
ЁЯХСя╕П	00, clock, time, two, роЗро░рогрпНроЯрпБ, роорогро┐
ЁЯХТя╕П	00, clock, three, time, роорогро┐, роорпВройрпНро▒рпБ
ЁЯХУя╕П	00, clock, four, time, роиро╛ройрпНроХрпБ, роиро╛ро▓рпБ, роорогро┐
ЁЯХФя╕П	00, clock, five, time, роРроирпНродрпБ, роорогро┐
ЁЯХХя╕П	00, clock, six, time, роЖро▒рпБ, роорогро┐
ЁЯХЦя╕П	00, clock, seven, роПро┤рпБ, роорогро┐
ЁЯХЧя╕П	00, clock, eight, time, роОроЯрпНроЯрпБ, роорогро┐
ЁЯХШя╕П	00, clock, nine, time, роТройрпНрокродрпБ, роорогро┐
ЁЯХЩя╕П	00, 10, clock, ten, рокродрпНродрпБ, роорогро┐
ЁЯХЪя╕П	00, 11, clock, eleven, time, рокродро┐ройрпКройрпНро▒рпБ, рокродро┐ройрпЛро░рпБ, роорогро┐
ЁЯХЫя╕П	00, 12, clock, time, twelve, рокройрпНройро┐ро░рогрпНроЯрпБ, роорогро┐
ЁЯХЬя╕П	30, clock, one, thirty, time, роТройрпНро▒ро░рпИ, роТройрпНро▒рпБ, роорогро┐, роорпБрокрпНрокродрпБ
ЁЯХЭя╕П	30, clock, thirty, time, two, роЗро░рогрпНроЯро░рпИ, роЗро░рогрпНроЯрпБ, роиро┐рооро┐роЯроорпН, роорогро┐, роорпБрокрпНрокродрпБ
ЁЯХЮя╕П	30, clock, thirty, three, time, роиро┐рооро┐роЯроорпН, роорогро┐, роорпБрокрпНрокродрпБ, роорпВройрпНро▒ро░рпИ, роорпВройрпНро▒рпБ
ЁЯХЯя╕П	30, clock, four, thirty, time, роиро╛ройрпНроХро░рпИ, роиро╛ройрпНроХрпБ, роорогро┐, роорпБрокрпНрокродрпБ
ЁЯХая╕П	30, clock, five, thirty, time, роРроирпНродро░рпИ, роРроирпНродрпБ, роорогро┐, роорпБрокрпНрокродрпБ
ЁЯХбя╕П	30, clock, six, thirty, роЖро▒ро░рпИ, роЖро▒рпБ, роорогро┐, роорпБрокрпНрокродрпБ
ЁЯХвя╕П	30, clock, seven, thirty, роПро┤ро░рпИ, роПро┤рпБ, роорогро┐, роорпБрокрпНрокродрпБ
ЁЯХгя╕П	30, clock, eight, thirty, time, роОроЯрпНроЯро░рпИ, роОроЯрпНроЯрпБ, роорогро┐, роорпБрокрпНрокродрпБ
ЁЯХдя╕П	30, clock, nine, thirty, time, роТройрпНрокродро░рпИ, роТройрпНрокродрпБ, роорогро┐, роорпБрокрпНрокродрпБ
ЁЯХея╕П	10, 30, clock, ten, thirty, time, рокродрпНродро░рпИ, рокродрпНродрпБ, роорогро┐, роорпБрокрпНрокродрпБ
ЁЯХжя╕П	11, 30, clock, eleven, thirty, time, рокродро┐ройрпКройрпНро▒ро░рпИ, рокродро┐ройрпКройрпНро▒рпБ, роорогро┐, роорпБрокрпНрокродрпБ
ЁЯХзя╕П	12, 30, clock, thirty, time, twelve, рокройрпНройро┐ро░рогрпНроЯро░рпИ, рокройрпНройро┐ро░рпЖрогрпНроЯро░рпИ, рокройрпНройро┐ро░рпЖрогрпНроЯрпБ, роорогро┐, роорпБрокрпНрокродрпБ
ЁЯХ╡я╕ПтАНтЩАя╕П	detective, sleuth, spy, woman, роХрогрпНроЯро▒ро┐, роХрогрпНроЯрпБрокро┐роЯро┐, роХро┐ро░рпИроорпН, роХрпБро▒рпНро▒роорпН, родрпБрокрпНрокро▒ро┐ропрпБроорпН, родрпБрокрпНрокро▒ро┐ро╡ро╛ро│ро░рпН, роирокро░рпН, роиро┐рокрпБрогро░рпН, рокрпЖрогрпН, ро╡ро┐роЪро╛ро░рогрпИ
ЁЯХ╡я╕ПтАНтЩВя╕П	detective, man, sleuth, spy, роЖрогрпН, родрпБрокрпНрокро▒ро┐ропрпБроорпН, родрпБрокрпНрокро▒ро┐ро╡ро╛ро│ро░рпН, роиро┐рокрпБрогро░рпН
ЁЯХ║	dance, dancer, dancing, elegant, festive, flair, flamenco, groove, let, man, salsa, tango, роГрокрпНро│ро╛роорпЖройрпНроХрпЛ, роЖроЯро▓ро╛роорпН, роЖроЯрпБрокро╡ро░рпН, роЖрогрпН, роХрпКрогрпНроЯро╛роЯрпНроЯроорпН, роХрпНро░рпВро╡рпН, роЪро▓рпНроЪро╛, роЯрпЗроЩрпНроХрпЛ, роироЯройроорпН, роиро│ро┐ройроорпН
ЁЯЧ╗	fuji, mount, mountain, nature, роЙроЪрпНроЪро┐, роОро╡ро░рпЖро╕рпНроЯрпН, роЪро┐роХро░роорпН, рокройро┐рооро▓рпИ, рооро▓рпИ, рооро▓рпИроЪрпНроЪро┐роХро░роорпН, роорпБроХроЯрпБ
ЁЯЧ╝	tokyo, tower, роХрпЛрокрпБро░роорпН, роЯро╡ро░рпН, роЯрпЛроХрпНроХро┐ропрпЛ
ЁЯЧ╜	liberty, new, ny, nyc, of, statue, york, роЪро┐ро▓рпИ, роЪрпБродроирпНродро┐ро░, роЪрпБродроирпНродро┐ро░родрпЗро╡ро┐, родрпЗро╡ро┐, роиро┐ропрпВропро╛ро░рпНроХрпН, ро▓ро┐рокро░рпНроЯро┐, ро▓ро┐рокро░рпНроЯрпНроЯро┐
ЁЯЧ╛	japan, map, of, роЬрокрпНрокро╛ройрпН, роорпЗрокрпН, ро╡ро░рпИрокроЯроорпН
ЁЯЧ┐	moai, moyai, statue, stoneface, travel, роХро▓рпН, роЪро┐ро▒рпНрокро┐, роЪро┐ро▓рпИ, рокропрогроорпН, рооройро┐род, роорпБроХроорпН, роорпЛропрпИ
ЁЯд░	pregnant, woman, роЙро│рпНро│, роХро░рпБродрпНродро░ро┐родрпНродрпБро│рпНро│, роХро░рпБродрпНродро░ро┐рокрпНрокрпБ, роХро░рпНрокрпНрокрооро╛роХ, роХро░рпНрокрпНрокро┐рогро┐, роирокро░рпН, роиро┐ро▒рпИрооро╛родроорпН, рокрпЖрогрпН
ЁЯд▒	baby, breast, feeding, mom, mother, nursing, woman, роЕроорпНрооро╛, роХрпБро┤роирпНродрпИ, роХрпИроХрпНроХрпБро┤роирпНродрпИ, роЪро┐роЪрпБ, родро╛ропрпН, родро╛ропрпНрокрпНрокро╛ро▓рпН, роирокро░рпН, рокро░ро╛рооро░ро┐рокрпНрокрпБ, рокро╛ро▓рпВроЯрпНроЯрпБроорпН, рокро╛ро▓рпН, рокрпЖрогрпН
ЁЯд┤	crown, fairy, fairytale, fantasy, king, prince, royal, royalty, tale, роЕро░роЪ, роЗро│ро╡ро░роЪройрпН, роЗро│ро╡ро░роЪро┐, роХрпБро▓роорпН, роирокро░рпН, ро░ро╛роЬрпНроЬро┐ропроорпН, ро╡роорпНроЪроорпН
ЁЯд╡	formal, in, person, tuxedo, wedding, роЕрогро┐роирпНродро╡ро░рпН, роХрпЛроЯрпН, роХрпЛроЯрпНроЯрпБ, роЪрпВроЯрпН, роЪрпВроЯрпНроЯрпБ, роирокро░рпН, роорогроороХройрпН, рооро╛рокрпНрокро┐ро│рпНро│рпИ
ЁЯд╡тАНтЩАя╕П	formal, in, tuxedo, wedding, woman, роЕрогро┐роирпНрод, роХрпЛроЯрпНроЯрпБ, роЪрпВроЯрпНроЯрпБ, рокрпЖрогрпН
ЁЯд╡тАНтЩВя╕П	formal, groom, in, man, tuxedo, wedding, роЕрогро┐роирпНрод, роЖрогрпН, роХрпЛроЯрпНроЯрпБ, роЪрпВроЯрпНроЯрпБ
ЁЯд╕	active, cartwheel, cartwheeling, excited, flip, gymnastic, gymnastics, happy, person, somersault, роЕроирпНродро░рпНрокро▓рпНроЯро┐, роЪрооро░рпНро╕ро╛ро▓рпНроЯрпН, роЬро┐роорпНройро╛ро╕рпНроЯро┐роХрпНро╕рпН, роирокро░рпН, рокро▓рпНроЯро┐, роороХро┐ро┤рпНроЪрпНроЪро┐, ро╡ро┐ро│рпИропро╛роЯрпНроЯрпБ
ЁЯд╕тАНтЩАя╕П	active, cartwheel, cartwheeling, excited, flip, gymnastic, gymnastics, happy, somersault, woman, роЙроЯро▒рпНрокропро┐ро▒рпНроЪро┐, роПро░рпЛрокро┐роХрпН, роЪро╛роХроЪроорпН, роЪрпЖропрпНропрпБроорпН, роЬро┐роорпНройро╛ро╕рпНроЯро┐роХрпНро╕рпН, роирокро░рпН, рокро▓рпНроЯро┐, рокрпЖрогрпН, ро╡ро┐ро│рпИропро╛роЯрпНроЯрпБ
ЁЯд╕тАНтЩВя╕П	active, cartwheel, cartwheeling, excited, flip, gymnastic, gymnastics, happy, man, somersault, роЖрогрпН, роЙроЯро▒рпНрокропро┐ро▒рпНроЪро┐, роПро░рпЛрокро┐роХрпН, роЪро╛роХроЪроорпН, роЪрпЖропрпНропрпБроорпН, роЬро┐роорпНройро╛ро╕рпНроЯро┐роХрпНро╕рпН, роирокро░рпН, рокро▓рпНроЯро┐, ро╡ро┐ро│рпИропро╛роЯрпНроЯрпБ
ЁЯд╣	act, balance, balancing, handle, juggle, juggling, manage, multitask, person, skill, роЖрогрпН, роЬроХрпНро│ро┐роЩрпН, родро┐ро▒ройрпН, роирокро░рпН, рокроирпНродрпБ
ЁЯд╣тАНтЩАя╕П	act, balance, balancing, handle, juggle, juggling, manage, multitask, skill, woman, роЕро╖рпНроЯро╛ро╡родро╛ройро┐, роЪрпЖропрпНропрпБроорпН, роЬроХрпНро│ро┐роЩрпН, родро┐ро▒ройрпН, роирокро░рпН, рокрогро┐роХро│рпН, рокроирпНродро╛роЯрпБродро▓рпН, рокроирпНродро╛роЯрпНроЯроорпН, рокро▓, рокрпЖрогрпН
ЁЯд╣тАНтЩВя╕П	act, balance, balancing, handle, juggle, juggling, man, manage, multitask, skill, роЕро╖рпНроЯро╛ро╡родро╛ройро┐, роЖрогрпН, роЪрпЖропрпНропрпБроорпН, роЬроХрпНро│ро┐роЩрпН, родро┐ро▒ройрпН, рокрогро┐роХро│рпН, рокроирпНродро╛роЯрпБродро▓рпН, рокроирпНродро╛роЯрпНроЯроорпН, рокро▓, ро╡ро┐родрпНродрпИ, ро╡ро┐родрпНродрпИроХро╛роЯрпНроЯро┐
ЁЯд║	fencer, fencing, person, sword, роХрпВро░рпНро╡ро╛ро│рпН, роЪрогрпНроЯрпИ, роирокро░рпН, ро╡ро╛ро│рпН, ро╡ро┐ро│рпИропро╛роЯрпНроЯрпБ
ЁЯд╝	combat, duel, grapple, people, ring, tournament, wrestle, wrestling, роХро│роорпН, роХрпБро╕рпНродро┐, роирокро░рпНроХро│рпН, рокрпЛроЯрпНроЯро┐, рооро▓рпНропрпБродрпНродрокрпН, рооро▓рпНропрпБродрпНродроорпН, ро╡ро┐ро│рпИропро╛роЯрпНроЯрпБ
ЁЯд╝тАНтЩАя╕П	combat, duel, grapple, ring, tournament, women, wrestle, wrestling, роХрпБро╕рпНродро┐, роЪрпЖропрпНропрпБроорпН, роирокро░рпН, рокрпЖрогрпН, рокрпЖрогрпНроХро│рпН, рокрпЛроЯрпНроЯро┐, рооро▓рпНропрпБродрпНродроорпН, ро░рпЖро╕рпНро▓ро┐роЩрпН, ро╡ро┐ро│рпИропро╛роЯрпНроЯрпБ
ЁЯд╝тАНтЩВя╕П	combat, duel, grapple, men, ring, tournament, wrestle, wrestling, роЖрогрпНроХро│рпН, роХрпБро╕рпНродро┐, роЪрогрпНроЯрпИ, роЪрпЖропрпНропрпБроорпН, родроЯроХро│роорпН, роирокро░рпН, рокрпЛроЯрпНроЯро┐, рооро▓рпНропрпБродрпНродроорпН, ро╡ро┐ро│рпИропро╛роЯрпНроЯрпБ
ЁЯд╜	person, playing, polo, sport, swimming, water, waterpolo, родрогрпНрогрпАро░рпН, роирокро░рпН, роирпАроЪрпНроЪро▓рпН, роирпАро░рпН, рокрпЛро▓рпЛ, ро╡ро╛роЯрпНроЯро░рпН, ро╡ро┐ро│рпИропро╛роЯрпНроЯрпБ
ЁЯд╜тАНтЩАя╕П	playing, polo, sport, swimming, water, waterpolo, woman, родроЯроХро│роорпН, роирокро░рпН, роирпАро░рпН, роирпАро░рпНрокрпН, рокроирпНродро╛роЯрпНроЯроорпН, рокроирпНродрпБ, рокрпЖрогрпН, рокрпЛро▓рпЛ, ро╡ро╛роЯрпНроЯро░рпН, ро╡ро┐ро│рпИропро╛роЯрпБроорпН, ро╡ро┐ро│рпИропро╛роЯрпНроЯрпБ
ЁЯд╜тАНтЩВя╕П	man, playing, polo, sport, swimming, water, waterpolo, роЖрогрпН, роирокро░рпН, роирпАро░рпН, роирпАро░рпНрокрпН, рокроирпНродро╛роЯрпНроЯроорпН, рокроирпНродрпБ, рокрпЛро▓рпЛ, ро╡ро╛роЯрпНроЯро░рпН, ро╡ро┐ро│рпИропро╛роЯрпБроорпН, ро╡ро┐ро│рпИропро╛роЯрпНроЯрпБ
ЁЯд╛	athletic, athletics, ball, catch, chuck, handball, hurl, lob, person, pitch, playing, sport, throw, tos, toss, роЖрогрпН, роОро▒ро┐родро▓рпН, роОро▒ро┐ропрпБроорпН, роХрпИрокрпНрокроирпНродрпБ, роХрпИропрпЖро▒ро┐, родроЯроХро│роорпН, роирокро░рпН, рокроирпНродрпБ, рокро┐роЯро┐родрпНродро▓рпН, ро╡ро┐ро│рпИропро╛роЯрпНроЯрпБ
ЁЯд╛тАНтЩАя╕П	athletic, athletics, ball, catch, chuck, handball, hurl, lob, pitch, playing, sport, throw, tos, toss, woman, роОро▒ро┐родро▓рпН, роХрпИрокрпНрокроирпНродрпБ, роирокро░рпН, рокроирпНродрпБ, рокро╛ро▓рпН, рокрпЖрогрпН, ро╡ро╛ро▓ро┐, ро╡ро┐ро│рпИропро╛роЯрпБроорпН, ро╡ро┐ро│рпИропро╛роЯрпНроЯрпБ, ро╣рпЗрогрпНроЯрпН
ЁЯд╛тАНтЩВя╕П	athletic, athletics, ball, catch, chuck, handball, hurl, lob, man, pitch, playing, sport, throw, tos, toss, роЖрогрпН, роХрпИрокрпНрокроирпНродрпБ, роирокро░рпН, рокроирпНродрпБ, рокро╛ро▓рпН, ро╡ро┐ро│рпИропро╛роЯрпБроорпН, ро╡ро┐ро│рпИропро╛роЯрпНроЯрпБ, ро╣рпЗройрпНроЯрпН
ЁЯд┐	diving, mask, scuba, snorkeling, роЯрпИро╡ро┐роЩрпН, рооро╛ро╕рпНроХрпН, ро╕рпНроХрпВрокро╛, ро╕рпНроирпЛро░рпНроХрпЖро▓ро┐роЩрпН, ро╕рпНройрпЛро░рпНроХрпЖро▓ро┐роЩрпН
ЁЯеА	dying, flower, wilted, рокрпВ, ро╡ро╛роЯро┐роп, ро╡ро╛роЯро┐ропродрпБ
ЁЯеБ	drum, drumstick, drumsticks, music, роЕроЯро┐, роЗроЪрпИ, роЯрооро╛ро░роорпН, роЯро┐ро░роорпН, роЯро┐ро░роорпНрооро░рпН, рокрпКро░рпБро│рпН, роородрпНродро│роорпН, роорпЗро│роорпН
ЁЯеВ	celebrate, clink, clinking, drink, glas, glass, glasse, glasses, роЙро▒рпНроЪро╛роХ, роЙро▒рпНроЪро╛роХроорпН, роХрпКрогрпНроЯро╛роЯрпНроЯроорпН, роХрпЛрокрпНрокрпИ, роЪро┐ропро░рпНро╕рпН, рокро╛ройроорпН
ЁЯеГ	glas, glass, liquor, scotch, shot, tumbler, whiskey, whisky, роХро┐ро│ро╛ро╕рпН, роХрпЛрокрпНрокрпИ, рокро╛ройроорпН, роородрпБ, ро╡ро┐ро╕рпНроХро┐, ро╕рпНроХро╛роЯрпНроЪрпН
ЁЯеД	eat, spoon, tableware, роЙрогро╡рпБ, роХро░рогрпНроЯро┐, роЪро┐ро▒рпБ, ро╕рпНрокрпВройрпН
ЁЯеЕ	goal, net, роХроорпНрокроорпН, роХро╛ро▓рпНрокроирпНродрпБ, роХрпЛро▓рпН, рокрпЛро╕рпНроЯрпН, ро╡ро┐ро│рпИропро╛роЯрпНроЯрпБ
ЁЯеЗ	1st, first, gold, medal, place, рокродроХрпНроХроорпН, рокро░ро┐роЪрпБ, роорпБродро▓рпН, роорпЖроЯро▓рпН, ро╡рпЖро▒рпНро▒ро┐ропро╛ро│ро░рпН
ЁЯеИ	2nd, medal, place, second, silver, роЗро░рогрпНроЯро╛ро╡родрпБ, рокродроХрпНроХроорпН, рокро░ро┐роЪрпБ
ЁЯеЙ	3rd, bronze, medal, place, third, рокродроХрпНроХроорпН, рокро░ро┐роЪрпБ, роорпВройрпНро▒ро╛ро╡родрпБ
ЁЯеК	boxing, glove, роХрпБродрпНродрпБ, роХрпБродрпНродрпБроЪрпНроЪрогрпНроЯрпИ, роХрпИропрпБро▒рпИ, роХрпНро│рпЛро╡рпН, родро▒рпНроХро╛рокрпНрокрпБ, рокройрпНроЪрпН
ЁЯеЛ	art, arts, judo, karate, martial, taekwondo, uniform, роЙроЯрпИ, роХро░ро╛родрпНродрпЗ, роЬрпВроЯрпЛ
ЁЯеМ	curling, game, rock, stone, роХро░рпНро▓ро┐роЩрпН, роХро▓рпН, рокро╛ро▒рпИ, ро╡ро┐ро│рпИропро╛роЯрпНроЯрпБ, ро╕рпНроЯрпЛройрпН
ЁЯеН	ball, goal, lacrosse, sport, sports, stick, роХрпЛро▓рпН, рокроирпНродрпБ, ро▓роХрпНро░рпЛро╕рпН, ро╕рпНроЯро┐роХрпН
ЁЯеО	ball, glove, softball, sport, sports, underarm, роХрпИропрпБро▒рпИ, роЪро╛роГрокрпНроЯрпН, роЪро╛рокрпНроЯрпНрокроирпНродрпБ, роЯрпЖройрпНройро┐ро╕рпН, рокроирпНродрпБ, рокро╛ро▓рпН, роорпЖройрпНрокроирпНродрпБ, ро╡ро┐ро│рпИропро╛роЯрпНроЯрпБ, ро╕ро╛роГрокрпНроЯрпН
ЁЯеП	disc, flying, ultimate, роГрокро┐ро░ро┐ро╕рпНрокро┐, роГрокрпНро░ро┐ро╕рпНрокро┐, роЪро╛роХроЪроорпН, рокро▒роХрпНроХрпБроорпН, рокрпКро┤рпБродрпБрокрпЛроХрпНроХрпБ, ро╡роЯрпНроЯрпБ, ро╡ро┐ро│рпИропро╛роЯрпНроЯрпБ
ЁЯеР	bread, breakfast, crescent, croissant, food, french, roll, роЙрогро╡рпБ, роХро┐ро░ро╛ропрпНроЪройрпНроЯрпН, роХро┐ро░рпЖроЪройрпНроЯрпН, рокрогрпНроЯроорпН, рокро┐ро░рпЖроЮрпНроЪрпБ, рокро┐ро░рпЖроЯрпН, рооро╛ро╡рпБрокрпН, рооро╛ро╡рпБрокрпНрокрогрпНроЯроорпН, ро░рпЛро▓рпН
ЁЯеС	avocado, food, fruit, роЕро╡роХрпЗроЯрпЛ, роЙрогро╡рпБ, рокро┤роорпН, ро╡рпЖрогрпНрогрпИрокрпН, ро╡рпЖрогрпНрогрпИрокрпНрокро┤роорпН
ЁЯеТ	cucumber, food, pickle, vegetable, роЙрогро╡рпБ, роХро╛ропрпНроХро▒ро┐, роЪро╛ро▓роЯрпН, рокроЪрпНроЪрпИ, ро╡рпЖро│рпНро│ро░ро┐
ЁЯеУ	bacon, breakfast, food, meat, роЕроЪрпИро╡роорпН, роЗро▒рпИроЪрпНроЪро┐, роЙрогро╡рпБ, рокройрпНро▒ро┐
ЁЯеФ	food, potato, vegetable, роЙрогро╡рпБ, роЙро░рпБро│рпИ, роЙро░рпБро│рпИроХрпНроХро┐ро┤роЩрпНроХрпБ, роХро╛ропрпН, роХро╛ропрпНроХро▒ро┐
ЁЯеХ	carrot, food, vegetable, роЙрогро╡рпБ, роХро╛ропрпН, роХро╛ропрпНроХро▒ро┐, роХрпЗро░роЯрпН, ро╡рпИроЯрпНроЯрооро┐ройрпН
ЁЯеЦ	baguette, bread, food, french, роГрокро┐ро░рпЖроЮрпНроЪрпБ, роЙрогро╡рпБ, роирпАро│, ро░рпКроЯрпНроЯро┐
ЁЯеЧ	food, green, salad, роЖро░рпЛроХрпНроХро┐ропроорпН, роЙрогро╡рпБ, роХро▓ро╡рпИ, роХро╛ропрпНроХро▒ро┐, роЪро╛ро▓роЯрпН
ЁЯеШ	casserole, food, of, paella, pan, shallow, роЙрогро╡рпБ, роХроЯро╛ропрпН, роХро┐ро░рпЗро╡ро┐, роХрпБро┤роорпНрокрпБ, роХрпВроЯрпНроЯрпБ, роЪро╛роорпНрокро╛ро░рпН, ро╡ро╛рогро▓ро┐
ЁЯеЩ	falafel, flatbread, food, gyro, kebab, stuffed, роГрокро▓ро╛роГрокро▓рпН, роЙрогро╡рпБ, роХрокро╛рокрпН, роХрпИро░рпЛ, роЯро╛роХрпЛ, ро░рпКроЯрпНроЯро┐, ро╡роХрпИ
ЁЯеЪ	breakfast, egg, food, роЙрогро╡рпБ, роорпБроЯрпНроЯрпИ
ЁЯеЫ	drink, glas, glass, milk, of, роХро┐ро│ро╛ро╕рпН, роХрпЛрокрпНрокрпИ, рокро╛ройроорпН, рокро╛ро▓рпН
ЁЯеЬ	food, nut, peanut, peanuts, vegetable, роЙрогро╡рпБ, роХроЯро▓рпИ, роХро╛ропрпНроХро▒ро┐, ро╡рпЗро░рпНроХрпНроХроЯро▓рпИ
ЁЯеЭ	food, fruit, kiwi, роЙрогро╡рпБ, роХро┐ро╡ро┐, роХро┐ро╡ро┐рокрпНрокро┤роорпН, рокро┤роорпН
ЁЯеЮ	breakfast, cr├кpe, food, hotcake, pancake, pancakes, роЗройро┐рокрпНрокрпБ, роЙрогро╡рпБ, роХро┐ро░рпАрокрпН, родрпЛроЪрпИ, рокрпЗройрпНроХрпЗроХрпН
ЁЯеЯ	dumpling, empanada, gy┼Нza, jiaozi, pierogi, potsticker, роЙрогро╡рпБ, роХрпКро┤рпБроХрпНроХроЯрпНроЯрпИ, роХрпНропрпЛро╕ро╛, роЪрпБроХро┐ропройрпН, роЪрпБропрпНропроорпН, роЬро┐ропро╛ро╕ро┐, роЬро┐ропрпЛро╕ро┐, роЯроорпНрокрпНро│ро┐роЩрпН, рокро╛роЯрпНро╕рпНроЯро┐роХрпНроХро░рпН
ЁЯеа	cookie, fortune, prophecy, роГрокро╛ро░рпНроЪрпНроЪрпВройрпН, роЕродро┐ро░рпНро╖рпНроЯ, роЙрогро╡рпБ, роХрпБроХрпНроХрпА, роЬрпЛроЪро┐ропроорпН
ЁЯеб	box, chopstick, chopsticks, delivery, food, oyster, pail, takeout, роЙрогро╡рпБ, роХрпЗро░ро┐ропро░рпН, роЪро╛рокрпНрокро╛роЯрпБрокрпН, роЯро┐рокройрпН, роЯрпЖро▓ро┐ро╡ро░ро┐, рокрпЖроЯрпНроЯро┐
ЁЯев	chopstick, chopsticks, hashi, jeotgarak, kuaizi, роЙрогро╡рпБ, роЪро╛рокрпНро╕рпНроЯро┐роХрпН, роЪрпАрой, роЬрокрпНрокро╛ройро┐роп, роирпВроЯрпБро▓рпНро╕рпН, ро╣ро╖ро┐
ЁЯег	bowl, breakfast, cereal, congee, oatmeal, porridge, spoon, роЙрогро╡рпБ, роЙро│рпНро│, роУроЯрпНро╕рпН, роХроЮрпНроЪро┐, роХро╛ро░рпНройрпНроГрокро┐ро│рпЗроХрпНро╕рпН, роХро╛ро▓рпИ, роХро┐рогрпНрогроорпН, роЪрпВрокрпН, рокро╛родрпНродро┐ро░роорпН, рокро┐ро░рпЗроХрпНроГрокро╛ро╕рпНроЯрпН, рокрпНро░рпЗроХрпНроГрокро╛ро╕рпНроЯрпН, ро╕рпНрокрпВройрпН
ЁЯед	cup, drink, juice, malt, soda, soft, straw, water, роЙро│рпНро│, роХрокрпН, роХрпЛрокрпНрокрпИ, роЪрпЛроЯро╛, роЬрпВро╕рпН, рокро┤роЪрпНроЪро╛ро▒рпБ, рокро╛ройроорпН, ро╕рпНроЯрпНро░ро╛
ЁЯее	coconut, colada, palm, pi├▒a, роЙрогро╡рпБ, роХрпКро▓роЯро╛, родрпЖройрпНройрпИ, родрпЗроЩрпНроХро╛ропрпН, рокройрпИ, рокро┐ройро╛, рооро░роорпН
ЁЯеж	broccoli, cabbage, wild, роЙрогро╡рпБ, роХро╛ропрпН, роХрпЛро╕рпН, рокро┐ро░роХрпНроХрпЛро▓ро┐, рокрпНро░рпКроХрпНроХрпЛро▓ро┐, роорпБроЯрпНроЯрпИроХрпЛро╕рпН
ЁЯез	apple, filling, fruit, meat, pastry, pie, pumpkin, slice, роГрокро┐ро▓рпНро▓ро┐роЩрпН, роЖрокрпНрокро┐ро│рпН, роЗройро┐рокрпНрокрпБ, роЙрогро╡рпБ, роХрпЗроХрпН, рокроорпНрокрпНроХро┐ройрпН, рокрпИ
ЁЯеи	convoluted, pretzel, twisted, роЙрогро╡рпБ, роирпКро▒рпБроХрпНроХрпБродрпНродрпАройро┐, рокро┐ро░рпЖроЯрпНро╕ро▓рпН, рокрпНро░рпЖро╕рпЖро▓рпН, роорпБро▒рпБроХрпНроХрпБ, ро╕рпНроирпЗроХрпНро╕рпН
ЁЯей	chop, cut, lambchop, meat, of, porkchop, red, steak, роЖроЯрпНроЯро┐ро▒рпИроЪрпНроЪро┐, роЗро▒рпИроЪрпНроЪро┐, роЗро▒рпИроЪрпНроЪро┐родрпН, роЙрогро╡рпБ, роЪро┐ро╡рокрпНрокрпБ, родрпБрогрпНроЯрпБ, рокройрпНро▒ро┐, рокройрпНро▒ро┐ропро┐ро▒рпИроЪрпНроЪро┐
ЁЯек	bread, sandwich, роЙрогро╡рпБ, роХро╛ро▓рпИропрпБрогро╡рпБ, роЪро╛рогрпНроЯрпНро╡ро┐роЪрпН, рокро┐ро░рпЖроЯрпН
ЁЯел	can, canned, food, роЕроЯрпИроХрпНроХрокрпНрокроЯрпНроЯ, роЙрогро╡рпБ, роХрпЗройро┐ро▓рпН, роХрпЗройрпН, рокродрокрпНрокроЯрпБродрпНродро┐роп
ЁЯем	bok, burger, burgers, cabbage, choy, green, kale, leafy, lettuce, salad, роЙрогро╡рпБ, роХро╛ропрпНроХро▒ро┐, роХрпЗрокрпЗроЬрпН, роХрпЛро╕рпН, роЪрпЛропрпН, рокроЪрпНроЪрпИ, рокрпЛроХрпН, роорпБроЯрпНроЯрпИроХрпЛро╕рпН, ро▓рпЖроЯрпНропрпВро╕рпН
ЁЯен	food, fruit, mango, tropical, роЙрогро╡рпБ, роЯрпНро░ро╛рокро┐роХро▓рпН, рокро┤роорпН, рооро╛роорпНрокро┤роорпН, роорпЗроЩрпНроХрпЛ
ЁЯео	autumn, cake, festival, moon, yu├иb╟Рng, роЗро▓рпИропрпБродро┐ро░рпНроХро╛ро▓роорпН, роХрпЗроХрпН, родро┐ро░рпБро╡ро┐ро┤ро╛, роорпВройрпН
ЁЯеп	bagel, bakery, bread, breakfast, schmear, роЙрогро╡рпБ, роХро╛ро▓рпИропрпБрогро╡рпБ, рокройрпН, рокро┐ро░рпЖроЯрпН, рокрпЗроХро▓рпН, рокрпЗроХрпНроХро░ро┐, ро╕рпНрокро┐ро░рпЖроЯрпН, ро╕рпНрооро┐ропро░рпН
ЁЯе╖	assassin, fight, fighter, hidden, ninja, person, secret, skill, skills, sly, soldier, stealth, war, роиро┐роЮрпНроЪро╛, рокрпЛро░ро╛ро│ро┐, рооро▒рпИроорпБроХрооро╛ройро╡ройрпН, ро╡рпАро░ро░рпН
ЁЯе╗	clothing, dres, dress, sari, роЖроЯрпИ, роЙроЯрпИ, роЪрпАро▓рпИ, роЪрпЗро▓рпИ, рокро╛ро░роорпНрокро░ро┐ропроорпН, рокрпБроЯро╡рпИ
ЁЯе╝	clothe, clothes, coat, doctor, dr, experiment, jacket, lab, scientist, white, роЖропрпНро╡роХ, роЙроЯрпИ, роХрпЛроЯрпН, роЯро╛роХрпНроЯро░рпН, рокро░ро┐роЪрпЛродройрпИ, рокрпКро░рпБро│рпН, рооро░рпБродрпНродрпБро╡ро░рпН, ро╡ро┐роЮрпНроЮро╛ройро┐
ЁЯе╜	dive, eye, goggle, goggles, protection, scuba, swimming, welding, роХрогрпН, роХрогрпНрогро╛роЯро┐роХро│рпН, роХро╛роХро┐ро│рпНро╕рпН, роирпАроЪрпНроЪро▓рпН, рокро╛родрпБроХро╛рокрпНрокрпБ, рокрпКро░рпБро│рпН, ро╡рпЖро▓рпНроЯро┐роЩрпН, ро╕рпНроХрпВрокро╛
ЁЯе╛	backpacking, boot, brown, camping, hiking, outdoor, outdoors, shoe, роХрпЗроорпНрокро┐роЩрпН, роХрпЗроорпНрокрпНрокро┐роЩрпН, рокрпВроЯрпН, рокрпЗроХрпНрокрпЗроХрпНроХро┐роЩрпН, рокрпКро░рпБро│рпН, рооро▓рпИропрпЗро▒рпНро▒, ро╣рпИроХрпНроХро┐роЩрпН
ЁЯе┐	ballet, comfy, flat, flats, on, shoe, slip, slipper, роГрокро┐ро│ро╛роЯрпН, роГрокро┐ро│ро╛роЯрпНро╕рпН, роЖройрпН, родроЯрпНроЯрпИропро╛рой, рокро╛ро▓рпЗ, рокрпКро░рпБро│рпН, ро╖рпВ, ро╕рпНро▓ро┐рокрпН, ро╕рпНро▓ро┐рокрпНрокро░рпН
ЁЯжА	cancer, crab, zodiac, роЙрогро╡рпБ, роХроЯроХ, роХроЯроХроорпН, роХроЯроХро░ро╛роЪро┐, роирогрпНроЯрпБ, ро░ро╛роЪро┐
ЁЯжБ	alpha, animal, leo, lion, mane, order, rawr, roar, safari, strong, zodiac, роЪроГрокро╛ро░ро┐, роЪрокро╛ро░ро┐, роЪро┐роЩрпНроХ, роЪро┐роЩрпНроХроорпН, роЪро┐роорпНроороорпН, рокрпКроорпНроорпИ, роорпБроХроорпН, ро░ро╛роЪро┐, ро▓ро┐ропрпЛ
ЁЯжВ	scorpio, scorpion, scorpiu, scorpius, zodiac, роХроЯро┐, родрпЗро│рпН, ро░ро╛роЪро┐, ро╡ро┐ро░рпБроЪрпНроЪро┐роХ, ро╡ро┐ро░рпБроЪрпНроЪро┐роХроорпН, ро╡ро┐ро╖роорпН, ро╕рпНроХро╛ро░рпНрокро┐ропройрпН, ро╕рпНроХро╛ро░рпНрокро┐ропрпЛ
ЁЯжГ	bird, gobble, thanksgiving, turkey, рокро▒ро╡рпИ, ро╡ро╛ройрпНроХрпЛро┤ро┐
ЁЯжД	unicorn, роТро▒рпНро▒рпИроХрпН, роХроЯро▓рпНроХрпБродро┐ро░рпИ, роХрпБродро┐ро░рпИ, роХрпКроорпНрокрпБ, роорпБроХроорпН
ЁЯжЕ	animal, bird, eagle, ornithology, роХро┤рпБроХрпБ, рокро▒ро╡рпИ
ЁЯжЖ	animal, bird, duck, ornithology, роХрпБро╡ро╛, рокро▒ро╡рпИ, ро╡ро╛родрпНродрпБ, ро╡ро┐ро▓роЩрпНроХрпБ
ЁЯжЗ	animal, bat, vampire, роЗро░родрпНродроХрпН, роЗро░ро╡рпБ, роХро╛роЯрпНроЯрпЗро░ро┐, ро╡ро┐ро▓роЩрпНроХрпБ, ро╡рпЗроорпНрокропро░рпН, ро╡рпМро╡ро╛ро▓рпН
ЁЯжИ	animal, fish, shark, роХроЯро▓рпН, роЪрпБро▒ро╛, родро┐рооро┐роЩрпНроХро▓роорпН, роорпАройрпН, ро╡ро┐ро▓роЩрпНроХрпБ, ро╖ро╛ро░рпНроХрпН
ЁЯжЙ	animal, bird, ornithology, owl, wise, роЖроирпНродрпИ, роЗро░ро╡рпБ, рокро▒ро╡рпИ
ЁЯжК	animal, fox, роХрпБро│рпНро│роиро░ро┐, роиро░ро┐, роорпБроХроорпН, ро╡ро┐ро▓роЩрпНроХрпБ
ЁЯжЛ	butterfly, insect, pretty, рокроЯрпНроЯро░рпНрокро┐ро│рпИ, рокроЯрпНроЯро╛роорпНрокрпВроЪрпНроЪро┐, рокрпВроЪрпНроЪро┐, ро╡рогрпНрогродрпНродрпБрокрпНрокрпВроЪрпНроЪро┐, ро╡рогрпНрогроорпН
ЁЯжМ	animal, deer, рооро╛ройрпН, ро╡ро┐ро▓роЩрпНроХрпБ
ЁЯжН	animal, gorilla, роХрпБро░роЩрпНроХрпБ, роХрпКро░ро┐ро▓рпНро▓ро╛, ро╡ро┐ро▓роЩрпНроХрпБ
ЁЯжО	animal, lizard, reptile, роЗро░рпБро╡ро╛ро┤рпНро╡ро┐, рокро▓рпНро▓ро┐
ЁЯжП	animal, rhinocero, rhinoceros, роХро╛рогрпНроЯро╛рооро┐ро░рпБроХроорпН, ро░ро┐ройрпЛ, ро░рпИройрпЛроЪро░ро╕рпН, ро╡ро┐ро▓роЩрпНроХрпБ
ЁЯжР	food, shellfish, shrimp, small, роЙрогро╡рпБ, роХрпВройро┐ро▒ро╛ро▓рпН, роорпАройрпН, ро╖рпЖро▓рпНроГрокро┐ро╖рпН
ЁЯжС	animal, food, mollusk, squid, роЙрогро╡рпБ, роХроЯро▓рпН, роХрогро╡ро╛ропрпН, ро╡ро┐ро▓роЩрпНроХрпБ, ро╕рпНроХрпНро╡ро┐роЯрпН
ЁЯжТ	animal, giraffe, spot, spots, роТроЯрпНроЯроХроЪрпНроЪро┐ро╡ро┐роЩрпНроХро┐, роЪро┐ро╡ро┐роЩрпНроХро┐, роЬро┐ро░ро╛роГрокрпН, рокрпБро│рпНро│ро┐роХро│рпН, ро╡ро┐ро▓роЩрпНроХрпБ
ЁЯжУ	animal, stripe, zebra, роХрпБродро┐ро░рпИ, роХрпЛроЯрпБ, роЬрпАрокрпНро░ро╛, ро╡ро░ро┐роХрпНроХрпБродро┐ро░рпИ, ро╡ро┐ро▓роЩрпНроХрпБ
ЁЯжФ	animal, hedgehog, spiny, роОро▓ро┐, роЪрпЖро▓рпНро▓рокрпНрокро┐ро░ро╛рогро┐, роорпБро│рпНро│рпЖро▓ро┐
ЁЯжХ	brachiosauru, brachiosaurus, brontosauru, brontosaurus, dinosaur, diplodocu, diplodocus, sauropod, роЪро░рпЛрокро╛роЯрпН, роЯрпИройрпЛроЪро░рпН, роЯрпИрокрпНро│рпЛроЯрпЛроХро╕рпН, рокро┐ро░ро╛роЩрпНроХро┐ропрпЛроЪро░ро╕рпН
ЁЯжЦ	dinosaur, rex, tyrannosauru, tyrannosaurus, роЬрпВро░ро╛роЪро┐роХрпНрокро╛ро░рпНроХрпН, роЯро┐, роЯро┐ройрпЛроЪро░рпН, роЯрпИройрпЛ, роЯрпИройрпЛроЪро░рпН, роЯрпИро░ро╛ройрпЛроЪро░ро╕рпН, ро░рпЖроХрпНро╕рпН
ЁЯжЧ	animal, bug, cricket, grasshopper, insect, orthoptera, роЗро░ро╛роХрпНроХрпЛро┤ро┐, роХро┐ро░ро╛ро╕рпНро╣рпЛрокрпНрокро░рпН, роХро┐ро░ро┐роХрпНроХрпЖроЯрпН, рокрпВроЪрпНроЪро┐, ро╡рпЖроЯрпНроЯрпБроХрпНроХро┐ро│ро┐
ЁЯжШ	animal, joey, jump, kangaroo, marsupial, роЖро╕рпНродро┐ро░рпЗро▓ро┐ропро╛, роХроЩрпНроХро╛ро░рпБ, роХрпБроЯрпНроЯро┐, роХрпБродро┐роХрпНроХрпБроорпН, рокрпИропрпБро│рпНро│
ЁЯжЩ	alpaca, animal, guanaco, llama, vicu├▒a, wool, роЕро▓рпНрокро╛роХро╛, роХроорпНрокро│ро┐, роХрпБро╡ро╛ройроХрпНроХрпЛ, ро▓ро╛рооро╛, ро╡ро┐ро▓роЩрпНроХрпБ, ро╡рпБройрпБройро╛
ЁЯжЪ	animal, bird, colorful, ornithology, ostentatiou, ostentatious, peacock, peahen, pretty, proud, родрпЗроЪро┐роп, рокро▒ро╡рпИ, рокрпЖрогрпН, рокрпЖро░рпБроорпИ, рооропро┐ро▓рпН, ро╡ро┐ропроХрпНроХродрпНродроХрпНроХ
ЁЯжЫ	animal, hippo, hippopotamu, hippopotamus, роирпАро░рпНропро╛ройрпИ, ро╡ро┐ро▓роЩрпНроХрпБ, ро╣ро┐рокрпНрокрпЛ, ро╣ро┐рокрпНрокрпЛрокрпЛроЯрооро╕рпН, ро╣ро┐рокрпНрокрпЛрокрпЛроЯрпНроЯрооро╕рпН
ЁЯжЬ	animal, bird, ornithology, parrot, pirate, talk, роХро┐ро│ро┐, роХрпКро│рпНро│рпИ, роЬрпЛроЪро┐ропроорпН, рокроЮрпНроЪро╡ро░рпНрогроорпН, рокро▒ро╡рпИ, рокрпЗроЪрпНроЪрпБ
ЁЯжЭ	animal, curiou, curious, raccoon, sly, роЖро░рпНро╡роорпН, родроирпНродро┐ро░роорпН, ро░роХрпНроХрпВройрпН, ро╡ро┐ро▓роЩрпНроХрпБ
ЁЯжЮ	animal, bisque, claw, claws, lobster, seafood, роЗро▒ро╛ро▓рпН, роЙрогро╡рпБ, роХроЯро▓рпН, роЪро┐роЩрпНроХ, роироХроЩрпНроХро│рпН, роирогрпНроЯрпБ, рокро┐ро╕рпНроХрпЗ, ро▓рпЛрокрпНро╕рпНроЯро░рпН
ЁЯжЯ	bite, disease, fever, insect, malaria, mosquito, pest, viru, virus, роХро╛ропрпНроЪрпНроЪро▓рпН, роХрпКроЪрпБ, роЯрпЖроЩрпНроХрпБ, роирпЛропрпН, рокрпВроЪрпНроЪро┐, рооро▓рпЗро░ро┐ропро╛, ро╡рпИро░ро╕рпН
ЁЯжа	amoeba, bacteria, microbe, science, viru, virus, роЕроорпАрокро╛, роЕро▒ро┐ро╡ро┐ропро▓рпН, роирпБрогрпНрогрпБропро┐ро░ро┐, рокро╛роХрпНроЯрпАро░ро┐ропро╛, ро╡рпИро░ро╕рпН
ЁЯжб	animal, badger, honey, pester, рокрпЗроЯрпНроЬро░рпН, ро╡ро│рпИроХрпНроХро░роЯро┐, ро╣ройро┐
ЁЯжв	animal, bird, cygnet, duckling, ornithology, swan, ugly, роЕройрпНройроХрпН, роЕройрпНройрокрпНрокро▒ро╡рпИ, роЕройрпНройрокрпНрокро▒ро╡рпИроХрпН, роЕройрпНройроорпН, роХрпБроЮрпНроЪрпБ, рокро▒ро╡рпИ
ЁЯжг	animal, extinction, large, mammoth, tusk, wooly, роЕро┤ро┐родро▓рпН, родроирпНродроорпН, рокрпЖро░ро┐роп, рокрпЖро░ро┐ропродрпБ, роороорпВродрпН, ропро╛ройрпИ
ЁЯжд	animal, bird, dodo, extinction, large, ornithology, роЕро┤ро┐ро╡рпБ, роЯрпЛроЯрпЛ, рокро▒ро╡рпИ, рокрпЖро░ро┐роп, роорпКро░ро┐ро╖ро┐ропро╕рпН, ро╡ро┐ро▓роЩрпНроХрпБ
ЁЯже	lazy, sloth, slow, роЕроЪрпИропро╛роХрпНроХро░роЯро┐, роЪрпЛроорпНрокро▓рпН, роЪрпЛроорпНрокрпЗро▒ро┐, ро╡ро┐ро▓роЩрпНроХрпБ, ро╕рпНро▓рпЛродрпН
ЁЯжж	animal, fishing, otter, playful, роХрпАро░ро┐, роиро╛ропрпН, роирпАро░рпН, роирпАро░рпНроиро╛ропрпН, роорпАройрпНрокро┐роЯро┐родрпНродро▓рпН, ро╡ро┐ро▓роЩрпНроХрпБ, ро╡ро┐ро│рпИропро╛роЯрпНроЯрпБродрпНродройроорпН
ЁЯжз	animal, ape, monkey, orangutan, роПрокрпН, роТро░ро╛роЩрпНроХрпБроЯрпНроЯро╛ройрпН, роХрпБро░роЩрпНроХрпБ, рооройро┐родроХрпНроХрпБро░роЩрпНроХрпБ, ро╡ро╛ро▓ро┐ро▓рпНро▓ро╛, ро╡ро┐ро▓роЩрпНроХрпБ
ЁЯжи	animal, skunk, stink, родрпАропро╡ро╛роЯрпИ, роорпБроЯрпИро╡ро│ро┐рооро╛, ро╡ро┐ро▓роЩрпНроХрпБ, ро╕рпНроХроЩрпНроХрпН, ро╕рпНроХройрпНроХрпН
ЁЯжй	animal, bird, flamboyant, flamingo, ornithology, tropical, роиро│ро┐ройроорпН, роиро╛ро░рпИ, рокро▒ро╡рпИ, рокрпВроиро╛ро░рпИ, ро╡рпЖрокрпНрокроорогрпНроЯро▓роорпН
ЁЯжк	diving, oyster, pearl, роЙрогро╡рпБ, роЙропро┐ро░ро┐ройроорпН, роУропро╕рпНроЯро░рпН, роХроЯро▓рпН, роЪро┐рокрпНрокро┐, роорпБродрпНродрпБ, ро╡роХрпИ, ро╡ро╛ро┤рпН
ЁЯжл	animal, beaver, dam, teeth, роЕрогрпИ, роЗройроорпН, роОро▓ро┐, рокро▓рпН, рокрпАро╡ро░рпН, ро╡ро┐ро▓роЩрпНроХрпБ
ЁЯжм	animal, bison, buffalo, herd, wisent, роОро░рпБроорпИ, роХро╛роЯрпБ, роХро╛роЯрпНроЯрпБ, роХро╛роЯрпНроЯрпЖро░рпБроорпИ, рокрпИроЪройрпН, роороирпНродрпИ, ро╡ро┐ро▓роЩрпНроХрпБ
ЁЯжн	animal, lion, ocean, sea, seal, роХроЯро▓рпН, роХроЯро▓рпНроиро╛ропрпН, роЪро┐роЩрпНроХроорпН, роЪрпАро▓рпН, ро╡ро┐ро▓роЩрпНроХрпБ
ЁЯжо	accessibility, animal, blind, dog, guide, роЪрпЖро▓рпНро▓рпБродро▓рпН, роиро╛ропрпН, рокро╛ро░рпНро╡рпИропро▒рпНро▒рпЛро░рпН, ро╡ро┤ро┐роХро╛роЯрпНроЯро┐
ЁЯжп	accessibility, blind, cane, probing, white, роХрпИродрпНродроЯро┐, рокро╛ро░рпНро╡рпИропро▒рпНро▒рпЛро░рпН, ро╡ро╛роХрпНроХро┐роЩрпН, ро╕рпНроЯро┐роХрпН
ЁЯж║	emergency, safety, vest, роЕро╡роЪро░, роОрооро░рпНроЬрпЖройрпНроЪро┐, роЪрпВро┤ро▓рпН, рокро╛родрпБроХро╛рокрпНрокрпБ, роорпЗро▒рпНроЪроЯрпНроЯрпИ, ро╡рпЖро╕рпНроЯрпН
ЁЯж╝	accessibility, motorized, wheelchair, роЗропроЩрпНроХрпБроорпН, роЙрокроХро░рогроорпН, роЪроХрпНроХро░, роЪрпЗро░рпН, роиро╛ро▒рпНроХро╛ро▓ро┐, рооро┐ройрпНройро╛ро▒рпНро▒ро▓ро┐ро▓рпН, роорпЛроЯрпНроЯро╛ро░рпН, ро╡рпАро▓рпН
ЁЯж╜	accessibility, manual, wheelchair, роЖро▒рпНро▒ро▓ро┐ро▓рпН, роЗропроЩрпНроХрпБроорпН, роЙрокроХро░рогроорпН, роЪроХрпНроХро░, роЪрпЗро░рпН, роиро╛ро▒рпНроХро╛ро▓ро┐, рооройро┐род, ро╡рпАро▓рпН
ЁЯзА	cheese, wedge, роХроЯрпНроЯро┐, роЪрпАро╕рпН, рокро╛ро▓ро╛роЯрпИ, рокро╛ро▓ро╛роЯрпИроХрпН, рокро╛ро▓рпЗроЯрпБ
ЁЯзБ	bakery, cupcake, dessert, sprinkle, sprinkles, sugar, sweet, treat, роЗройро┐рокрпНрокрпБ, роЙрогро╡рпБ, роХрокрпН, роХрокрпНроХрпЗроХрпН, роХрпЗроХрпН, роЯрпЖро╕ро░рпНроЯрпН, рокрпЗроХрпНроХро░ро┐
ЁЯзВ	condiment, flavor, mad, salt, salty, shaker, taste, upset, роЙрогро╡рпБ, роЙрокрпНрокрпБ, роЪрпБро╡рпИ, роЪрпБро╡рпИропрпВроЯрпНроЯро┐, ро╖рпЗроХрпНроХро░рпН
ЁЯзГ	beverage, box, juice, straw, sweet, роХрпБроЯро┐рокро╛ройрокрпН, роЬрпВро╕рпН, роЯрокрпНрокро╛, рокро┤роЪрпНроЪро╛ро▒рпБ, рокро╛роХрпНро╕рпН, рокро╛ройроорпН, рокрпЖроЯрпНроЯро┐, ро╕рпНроЯро┐ро░ро╛, ро╕рпНроЯрпНро░ро╛
ЁЯзД	flavoring, garlic, роЙрогро╡рпБ, роЪрпБро╡рпИ, рокрпВрогрпНроЯрпБ, рооро░рпБроирпНродрпБ, ро╡ро╛роЪроорпН
ЁЯзЕ	flavoring, onion, роЖройро┐ропройрпН, роЙрогро╡рпБ, роЪрпБро╡рпИ, ро╡рпЖроЩрпНроХро╛ропроорпН
ЁЯзЖ	chickpea, falafel, meatball, роГрокро▓ро╛роГрокро▓рпН, роЙрогро╡рпБ, роЙро░рпБрогрпНроЯрпИ, роХро▒ро┐, роХрпКрогрпНроЯрпИроХрпНроХроЯро▓рпИ, ро░ро╛рокрпН, ро╡ро▒рпБродрпНрод
ЁЯзЗ	breakfast, indecisive, iron, waffle, роЗро░рпБроорпНрокрпБ, роЙро▒рпБродро┐ропро▒рпНро▒родрпБ, роХро╛ро▓рпИропрпБрогро╡рпБ, ро╡ро╛роГрокро┐ро│рпН, ро╡рпЗроГрокро┐ро▓рпН
ЁЯзИ	butter, dairy, роХрпКро┤рпБрокрпНрокрпБ, роЪро╛рогрпНроЯрпНро╡ро┐роЪрпН, рокро╛ро▓рпН, рокрпКро░рпБроЯрпНроХро│рпН, рокрпКро░рпБро│рпН, ро╡рпЖрогрпНрогрпЖропрпН
ЁЯзЙ	drink, mate, роХрпБро│ро┐ро░рпНрокро╛ройроорпН, роЬрпВро╕рпН, рокро╛ройроорпН, роорпЗроЯрпН
ЁЯзК	cold, cube, ice, iceberg, роРро╕рпН, роХроЯрпНроЯро┐, роХро┐ропрпВрокрпН, роХрпБро│ро┐ро░рпН
ЁЯзЛ	boba, bubble, food, milk, pearl, tea, роЙрогро╡рпБ, роХрпБрооро┐ро┤ро┐, роХрпБрооро┐ро┤ро┐родрпН, роЯрпА, родрпЗроирпАро░рпН, рокрокрпБро│рпН, рокропрогроорпН, рокро╛ро▓рпН, рокрпЛрокро╛, роорпБродрпНродрпБ
ЁЯзН	person, stand, standing, роирокро░рпН, роиро┐рооро┐ро░рпНроирпНродрпБ, роиро┐ро▒рпНрокродрпБ, роиро┐ро▒рпНро▒ро▓рпН, роиро┐ро▓рпН, роирпЗро░ро╛роХ
ЁЯзНтАНтЩАя╕П	stand, standing, woman, роиро┐ро▒рпНроХрпБроорпН, роиро┐ро▒рпНрокродрпБ, рокрпЖрогрпН
ЁЯзНтАНтЩВя╕П	man, stand, standing, роЖрогрпН, роиро┐ро▒рпНроХрпБроорпН, роиро┐ро▒рпНрокродрпБ
ЁЯзО	knee, kneel, kneeling, knees, person, роЖроЪройроорпН, родрпКро┤рпБроХрпИ, роирокро░рпН, роорогрпНроЯро┐ропро┐роЯро▓рпН, роорогрпНроЯро┐ропро┐роЯрпБродро▓рпН, роорпБро┤роЩрпНроХро╛ро▓ро┐роЯрпБродро▓рпН, ро╡роЬрпНро░ро╛роЪройроорпН
ЁЯзОтАНтЩАя╕П	knee, kneel, kneeling, knees, woman, рокрпЖрогрпН, роорогрпНроЯро┐ропро┐роЯрпНроЯрпБро│рпНро│, роорпБро┤роЩрпНроХро╛ро▓ро┐роЯрпБродро▓рпН
ЁЯзОтАНтЩАя╕ПтАНтЮбя╕П	facing, knee, kneel, kneeling, knees, right, woman
ЁЯзОтАНтЩВя╕П	knee, kneel, kneeling, knees, man, роЖрогрпН, роорогрпНроЯро┐ропро┐роЯрпНроЯрпБро│рпНро│, роорпБро┤роЩрпНроХро╛ро▓ро┐роЯрпБродро▓рпН
ЁЯзОтАНтЩВя╕ПтАНтЮбя╕П	facing, knee, kneel, kneeling, knees, man, right
ЁЯзОтАНтЮбя╕П	facing, knee, kneel, kneeling, knees, person, right
ЁЯзСтАНтЪХя╕П	doctor, health, healthcare, nurse, therapist, worker, роЕро│ро┐рокрпНрокро╡ро░рпН, роЪро┐роХро┐роЪрпНроЪрпИ, роЪрпБроХро╛родро╛ро░, роЪрпЖро╡ро┐ро▓ро┐ропро░рпН, роЪрпЗро╡рпИ, рокрогро┐ропро╛ро│ро░рпН, рооро░рпБродрпНродрпБро╡, рооро░рпБродрпНродрпБро╡ро░рпН
ЁЯзСтАНтЪЦя╕П	judge, justice, law, scale, scales, роирпАродро┐рокродро┐, роородро┐рокрпНрокрпАроЯрпБроХро│рпН
ЁЯзСтАНтЬИя╕П	pilot, plane, роУроЯрпНроЯро┐, ро╡ро┐рооро╛рой, ро╡ро┐рооро╛ройроорпН
ЁЯзСтАНЁЯМ╛	farmer, gardener, rancher, роЪрпЖропрпНрокро╡ро░рпН, родрпЛроЯрпНроЯроХрпНроХро╛ро░ро░рпН, рокрогро┐, рокрогрпНрогрпИропро┐ро▓рпН, ро╡ро┐ро╡роЪро╛ропро┐
ЁЯзСтАНЁЯН│	chef, cook, роЪроорпИропро▓рпНроХро╛ро░ро░рпН, роЪрпЖроГрокрпН
ЁЯзСтАНЁЯН╝	baby, feed, feeding, nanny, newborn, nursing, parent, person, роЕрокрпНрокро╛, роЕроорпНрооро╛, роХрпБро┤роирпНродрпИ, роХрпБро┤роирпНродрпИроХрпНроХрпБ, родроирпНродрпИ, родро╛ропрпН, роирокро░рпН, рокро╛ро▓рпВроЯрпНроЯрпБродро▓рпН, рокро╛ро▓рпВроЯрпНроЯрпБроорпН
ЁЯзСтАНЁЯОУ	graduate, student, рокроЯрпНроЯродро╛ро░ро┐, рооро╛рогро╡ро░рпН
ЁЯзСтАНЁЯОд	actor, entertainer, rock, rockstar, singer, star, роХрпЗро│ро┐роХрпНроХрпИропро╛ро│ро░рпН, роироЯро┐роХро░рпН, роироЯрпНроЪродрпНродро┐ро░роорпН, рокро╛роЯроХро░рпН
ЁЯзСтАНЁЯОи	artist, palette, роХро▓рпИроЮро░рпН, ро╡рогрпНрогродрпНродроЯрпНроЯрпБ
ЁЯзСтАНЁЯПл	instructor, lecturer, professor, teacher, роЖроЪро┐ро░ро┐ропро░рпН, рокропро┐ро▒рпНро▒рпБро╡ро┐рокрпНрокро╛ро│ро░рпН, рокрпЗро░ро╛роЪро┐ро░ро┐ропро░рпН
ЁЯзСтАНЁЯПн	assembly, factory, industrial, worker, роЪрокрпИ, родрпКро┤ро┐ро▒рпНроЪро╛ро▓рпИ, родрпКро┤ро┐ро▓ро╛ро│ро┐, родрпКро┤ро┐ро▓рпНродрпБро▒рпИ
ЁЯзСтАНЁЯТ╗	coder, computer, developer, inventor, software, technologist, роХрогрпНроЯрпБрокро┐роЯро┐рокрпНрокро╛ро│ро░рпН, роХрпБро▒ро┐рокрпНрокро╛ройрпН, роЯрпЖро╡рпЖро▓рокро░рпН, родрпКро┤ро┐ро▓рпН, роирпБроЯрпНрок, роорпЖройрпНрокрпКро░рпБро│рпН, ро╡ро▓рпНро▓рпБроиро░рпН
ЁЯзСтАНЁЯТ╝	architect, busines, business, collar, manager, office, white, worker, роЕро▓рпБро╡ро▓роХрокрпН, роХроЯрпНроЯро┐роЯроХрпНроХро▓рпИ, роХро╛ро▓ро░рпН, рокрогро┐ропро╛ро│ро░рпН, роорпЗро▓ро╛ро│ро░рпН, ро╡рогро┐роХ, ро╡рпИроЯрпН
ЁЯзСтАНЁЯФз	electrician, mechanic, plumber, tradesperson, роОро▓роХрпНроЯрпНро░рпАро╖ро┐ропройрпН, рокро┐ро│роорпНрокро░рпН, роорпЖроХрпНроХро╛ройро┐роХрпН
ЁЯзСтАНЁЯФм	biologist, chemist, engineer, mathematician, physicist, scientist, роЗропро▒рпНрокро┐ропро▓ро╛ро│ро░рпН, роЙропро┐ро░ро┐ропро▓ро╛ро│ро░рпН, рокрпКро▒ро┐ропро╛ро│ро░рпН, ро╡ро┐роЮрпНроЮро╛ройро┐, ро╡рпЗродро┐ропро┐ропро▓ро╛ро│ро░рпН
ЁЯзСтАНЁЯжп	accessibility, blind, cane, person, probing, white, роХрогрпН, роХрпЛро│ро╛ро▒рпБ, родроЯро┐ропрпБроЯройрпН, родрпЖро░ро┐ропро╛родро╡ро░рпН, роироЯроХрпНроХрпБроорпН, роирокро░рпН, рокро╛ро░рпНро╡рпИ
ЁЯзСтАНЁЯжптАНтЮбя╕П	accessibility, blind, cane, facing, person, probing, right, white
ЁЯзСтАНЁЯж╝	accessibility, in, motorized, person, wheelchair, роЕрогрпБроХро▓рпНродройрпНроорпИ, роЗро░рпБроХрпНроХрпБроорпН, роЪроХрпНроХро░, роирокро░рпН, роиро╛ро▒рпНроХро╛ро▓ро┐, роиро╛ро▒рпНроХро╛ро▓ро┐ропро┐ро▓рпН, роорпЛроЯрпНроЯро╛ро░рпН
ЁЯзСтАНЁЯж╝тАНтЮбя╕П	accessibility, facing, in, motorized, person, right, wheelchair
ЁЯзСтАНЁЯж╜	accessibility, in, manual, person, wheelchair, роЕрогрпБроХро▓рпНродройрпНроорпИ, роЗро░рпБроХрпНроХрпБроорпН, роЙроирпНродрокрпНрокроЯрпБроорпН, роХрпИропро╛ро▓рпН, роЪроХрпНроХро░, роирокро░рпН, роиро╛ро▒рпНроХро╛ро▓ро┐, роиро╛ро▒рпНроХро╛ро▓ро┐ропро┐ро▓рпН
ЁЯзСтАНЁЯж╜тАНтЮбя╕П	accessibility, facing, in, manual, person, right, wheelchair
ЁЯзСтАНЁЯй░	ballet, dancer, роХро▓рпИроЮро░рпН, роЯро╛ройрпНроЪро░рпН, роЯро╛ройрпНро╕ро░рпН, роироЯройроХрпН, рокро╛ро▓роЯрпН
ЁЯзСтАНЁЯЪА	astronaut, rocket, space, ро░ро╛роХрпНроХрпЖроЯрпН, ро╡ро┐рогрпНро╡рпЖро│ро┐, ро╡рпАро░ро░рпН
ЁЯзСтАНЁЯЪТ	fire, firefighter, firetruck, родрпАропрогрпИрокрпНрокрпБ, ро╡рогрпНроЯро┐, ро╡рпАро░ро░рпН
ЁЯзХ	bandana, head, headscarf, hijab, kerchief, mantilla, tichel, woman, роЕрогро┐роирпНрод, роЯро┐роЪрпЖро▓рпН, родро▓рпИ, родро▓рпИропро┐ро▓рпН, рокрпЖрогрпН, рооро╛рогрпНроЯро┐ро▓ро╛, ро╕рпНроХро╛ро░рпНроГрокрпН, ро╣ро┐роЬро╛рокрпН
ЁЯзЦ	day, in, luxuriou, luxurious, pamper, person, relax, room, sauna, spa, steam, steambath, steamy, unwind, роЕро▒рпИ, роХрпБро│ро┐роХрпНроХрпБроорпН, роХрпБро│ро┐ропро▓рпН, роЪро╡ро╛ройро╛, роирокро░рпН, роирпАро░ро╛ро╡ро┐, роирпАро░ро╛ро╡ро┐роХрпН, ро╕рпНрокро╛
ЁЯзЦтАНтЩАя╕П	day, in, luxuriou, luxurious, pamper, relax, room, sauna, spa, steam, steambath, steamy, unwind, woman, роЕро▒рпИ, роОроЯрпБроХрпНроХрпБроорпН, роХрпБро│ро┐ропро▓рпН, роЪро╡ро╛ройро╛, роирпАро░ро╛ро╡ро┐, роирпАро░ро╛ро╡ро┐роХрпН, рокрпЖрогрпН
ЁЯзЦтАНтЩВя╕П	day, in, luxuriou, luxurious, man, pamper, relax, room, sauna, spa, steam, steambath, steamy, unwind, роЕро▒рпИ, роЖрогрпН, роОроЯрпБроХрпНроХрпБроорпН, роХрпБро│ро┐ропро▓рпН, роЪро╡ро╛ройро╛, роирпАро░ро╛ро╡ро┐, роирпАро░ро╛ро╡ро┐роХрпН
ЁЯзЧ	climb, climber, climbing, mountain, person, rock, scale, up, роПро▒рпБроорпН, роирокро░рпН, рокрпЖрогрпН, рооро▓рпИ, рооро▓рпИропрпЗро▒рпБрокро╡ро░рпН, рооро▓рпИропрпЗро▒рпНро▒роорпН
ЁЯзЧтАНтЩАя╕П	climb, climber, climbing, mountain, rock, scale, up, woman, рокрпЖрогрпН, рооро▓рпИ, рооро▓рпИропрпЗро▒рпБрокро╡ро░рпН, рооро▓рпИропрпЗро▒рпБроорпН, рооро▓рпИропрпЗро▒рпНро▒роорпН
ЁЯзЧтАНтЩВя╕П	climb, climber, climbing, man, mountain, rock, scale, up, роЖрогрпН, рооро▓рпИ, рооро▓рпИропрпЗро▒рпБрокро╡ро░рпН, рооро▓рпИропрпЗро▒рпБроорпН, рооро▓рпИропрпЗро▒рпНро▒роорпН
ЁЯзШ	cros, cross, in, leg, legged, legs, lotu, lotus, meditation, peace, person, position, relax, serenity, yoga, yogi, zen, роЕроорпИродро┐, роЖроЪройроорпН, роЪроорпНроорогроорпН, роЬрпЖройрпН, родро┐ропро╛ройроорпН, роирокро░рпН, рокродрпНрооро╛роЪройроорпН, рокрпЖрогрпН, ропрпЛроХро╛
ЁЯзШтАНтЩАя╕П	cros, cross, in, leg, legged, legs, lotu, lotus, meditation, peace, position, relax, serenity, woman, yoga, yogi, zen, роЖроЪройроорпН, роЪрпЖропрпНропрпБроорпН, родро┐ропро╛ройроорпН, рокродрпНрооро╛роЪройроорпН, рокрпЖрогрпН, ропрпЛроХро╛
ЁЯзШтАНтЩВя╕П	cros, cross, in, leg, legged, legs, lotu, lotus, man, meditation, peace, position, relax, serenity, yoga, yogi, zen, роЖроЪройроорпН, роЖрогрпН, роЪрпЖропрпНропрпБроорпН, родро┐ропро╛ройроорпН, рокродрпНрооро╛роЪройроорпН, ропрпЛроХро╛
ЁЯзв	baseball, bent, billed, cap, dad, hat, роХрпЛроЯрпИ, роЪро┐ройрпНройроорпБро│рпНро│, родрпКрокрпНрокро┐, рокрпЗро╕рпНрокро╛ро▓рпН, рокрпКро░рпБро│рпН, ро╡рпЖропро┐ро▓рпН
ЁЯзг	bundle, cold, neck, scarf, up, роЕрогро┐, роХро┤рпБродрпНродрпБ, роХрпБро│ро┐ро░рпН, рокрпКро░рпБро│рпН, ро╕рпНроХро╛ро░рпНроГрокрпН, ро╕рпНроЯрпИро▓рпН
ЁЯзд	glove, gloves, hand, роХро┐ро│ро╡рпБро╕рпН, роХрпИ, роХрпИропрпБро▒рпИ, роХрпИропрпБро▒рпИроХро│рпН, рокро╛родрпБроХро╛рокрпНрокрпБ, рокрпКро░рпБро│рпН
ЁЯзе	brr, bundle, coat, cold, jacket, up, роЖроЯрпИ, роХроорпНрокро│ро┐, роХрпБро│ро┐ро░рпН, роХрпЛроЯрпН, роЪро┐ро╡рокрпНрокрпБ, роЪрпВроЯрпН, роЬро╛роХрпНроХрпЖроЯрпН, рокрпКро░рпБро│рпН
ЁЯзж	sock, socks, stocking, роХро╛ро▓рпБро▒рпИ, роХрпБро│ро┐ро░рпН, роЪро╛роХрпНро╕рпН, рокрпКро░рпБро│рпН, ро╕рпНроЯро╛роХрпНроХро┐роЩрпНро╕рпН, ро╕рпНроЯрпИро▓рпН
ЁЯзз	envelope, gift, good, h├│ngb─Бo, lai, luck, money, red, see, роЙро▒рпИ, роХро╡ро░рпН, роЪройрпНрооро╛ройроорпН, роЪро┐ро╡рокрпНрокрпБ, рокрогроорпН, рокро░ро┐роЪрпБ, роорпКропрпН, ро╡ро╛ро┤рпНродрпНродрпБ
ЁЯзи	dynamite, explosive, fire, firecracker, firework, fireworks, light, pop, popping, spark, роЯрпИройроорпИроЯрпН, рокро╛роорпН, ро╡ро╛ройро╡рпЗроЯро┐роХрпНроХрпИ, ро╡рпЖроЯро┐, ро╡рпЖроЯро┐рокрпНрокрпКро░рпБро│рпН, ро╡рпЖроЯро┐рооро░рпБроирпНродрпБ
ЁЯзй	clue, interlocking, jigsaw, piece, puzzle, роХрпНро│рпВ, роЪрпЗро░рпНродрпНродро▓рпН, роЬро┐роХрпНро╕ро╛, родрпБрогрпНроЯрпБ, родрпБрокрпНрокрпБ, рокрпБродро┐ро░рпН
ЁЯзк	chemist, chemistry, experiment, lab, science, test, tube, роЕро▒ро┐ро╡ро┐ропро▓рпН, роЖропрпНро╡рпБроХрпНроХрпВроЯроорпН, роХрпБро┤ро╛ропрпН, роЪрпЛродройрпИроХрпН, роЪрпЛродройрпИроХрпНроХрпБро┤ро╛ропрпН, рокро░ро┐роЪрпЛродройрпИ, рокрпКро░рпБро│рпН, ро╡рпЗродро┐ропро▓ро╛ро│ро░рпН, ро╡рпЗродро┐ропро┐ропро▓ро░рпН, ро╡рпЗродро┐ропро┐ропро▓рпН
ЁЯзл	bacteria, biologist, biology, culture, dish, lab, petri, роЖропрпНро╡роХроорпН, роЙропро┐ро░ро┐ропро▓ро╛ро│ро░рпН, роЙропро┐ро░ро┐ропро▓рпН, роХро▓ро╛роЪрпНроЪро╛ро░роорпН, роЯро┐ро╖рпН, рокро╛роХрпНроЯрпАро░ро┐ропро╛, рокрпЖроЯрпНро░ро┐, рокрпКро░рпБро│рпН
ЁЯзм	biologist, dna, evolution, gene, genetic, genetics, life, роЙропро┐ро░ро┐ропро▓ро╛ро│ро░рпН, роЬрпАройрпН, роЯро┐роОройрпНроП, рокро░ро┐рогро╛роороорпН, рокрпКро░рпБро│рпН, рооро░рокрогрпБ, рооро░рокро┐ропро▓рпН, ро╡ро╛ро┤рпНроХрпНроХрпИ
ЁЯзн	compas, compass, direction, magnetic, navigation, orienteering, роУро░ро┐ропройрпНроЯрпН, роХро╛роорпНрокро╕рпН, родро┐роЪрпИ, родро┐роЪрпИроХро╛роЯрпНроЯро┐, роирпЗро╡ро┐роХрпЗро╖ройрпН, роорпЗроХрпНройроЯрпНроЯро┐роХрпН, ро╡ро┤ро┐, ро╡ро┤ро┐роЪрпНроЪрпЖро▓рпБродрпНродро▓рпН
ЁЯзо	abacu, abacus, calculation, calculator, роЕрокро╛роХро╕рпН, роЕрокро╛роХрпНроХро╕рпН, роХрогроХрпНроХрпАроЯрпБ, роХрогроХрпНроХрпБ, роХрогро┐родроорпН, роХрогро┐рокрпНрокро╛ройрпН, рокрпКро░рпБро│рпН
ЁЯзп	extinguish, extinguisher, fire, quench, роЕрогрпИродрпНродро▓рпН, роЕрогрпИрокрпНрокро╛ройрпН, родрогро┐родрпНродро▓рпН, родрпА, родрпАропрогрпИрокрпНрокро╛ройрпН, рокрпКро░рпБро│рпН
ЁЯз░	box, chest, mechanic, red, tool, toolbox, роХро░рпБро╡ро┐рокрпНрокрпЖроЯрпНроЯро┐, роЯрпВро▓рпН, роЯрпВро▓рпНрокро╛роХрпНро╕рпН, рооро╛ро░рпНрокрпБ, роорпЖроХрпНроХро╛ройро┐роХрпН
ЁЯз▒	brick, bricks, clay, mortar, wall, роХро│ро┐роорогрпН, роХро╛ро░рпИ, роЪрпБро╡ро░рпН, роЪрпЖроЩрпНроХро▓рпН, роЪрпЖроЩрпНроХро▓рпНроХро│рпН
ЁЯз▓	attraction, horseshoe, magnet, magnetic, negative, positive, shape, роИро░рпНрокрпНрокрпБ, роХро╛роирпНродроорпН, роХрпБродро┐ро░рпИро▓ро╛роЯроорпН, ро▓ро╛роЯроорпН
ЁЯз│	bag, luggage, packing, roller, suitcase, travel, роЪрпВроЯрпНроХрпЗро╕рпН, роЯро┐ро░ро╛ро▓ро┐, рокропрогрокрпН, рокропрогроорпН, рокрпЗроХрпНроХро┐роЩрпН, рокрпКродро┐, ро▓роХрпНроХрпЗроЬрпН, ро╕рпНроЯрпНро░ро╛ро▓ро┐
ЁЯз┤	bottle, lotion, moisturizer, shampoo, sunscreen, роЪройрпНро╕рпНроХро┐ро░рпАройрпН, рокро╛роЯрпНроЯро┐ро▓рпН, рокрпКро░рпБро│рпН, рооро╛ропрпНро╕рпНроЪро░рпИроЪро░рпН, ро▓рпЛро╖ройрпН, ро╖ро╛роорпНрокрпБ
ЁЯз╡	needle, sewing, spool, string, thread, роЗро┤рпИ, роКроЪро┐, роХрогрпНроЯрпБ, роЪро░роорпН, родрпИропро▓рпН, роирпВро▓рпН, ро╕рпНрокрпВро▓рпН
ЁЯз╢	ball, crochet, knit, yarn, роХрпБро│ро┐ро░ро╛роЯрпИ, роХрпИро╡рпЗро▓рпИ, роХрпКроХрпНроХро┐рокрпНрокро┐ройрпНройро▓рпН, роХрпНро░рпЛро╖ро╛, роирпВро▓рпНроХрогрпНроЯрпБ, рокроирпНродрпБ, рокро┐ройрпНройро▓рпН
ЁЯз╖	diaper, pin, punk, rock, safety, роКроХрпНроХрпБ, роХро╛рокрпНрокрпВроЪро┐, роЪрпЗроГрокрпНроЯро┐, роЯропрокро░рпН, рокроЩрпНроХрпН, рокро┐ройрпН, ро░ро╛роХрпН
ЁЯз╕	bear, plaything, plush, stuffed, teddy, toy, роХро░роЯро┐, роЯро╛ропрпН, роЯрпЖроЯро┐, роЯрпЖроЯро┐рокро┐ропро░рпН, роЯрпЖроЯрпНроЯро┐, рокроЮрпНроЪрпБ, рокроЯрпНроЯрпБ, рокро┐ропро░рпН, рокрпКроорпНроорпИ, рокрпКроорпНроорпИроХрпН, ро╡ро┐ро│рпИропро╛роЯрпНроЯрпБрокрпНрокрпКро░рпБро│рпН, ро╕ро╛роГрокрпНроЯрпН
ЁЯз╣	broom, cleaning, sweeping, witch, роЪрпБродрпНродроорпН, роЪрпВройро┐ропроХрпНроХро╛ро░ро┐, родрпБроЯрпИрокрпНрокроорпН, родрпБрокрпНрокрпБро░ро╡рпБ
ЁЯз║	basket, farming, laundry, picnic, роХрпВроЯрпИ, роЪро▓ро╡рпИ, роЪрпБро▒рпНро▒рпБро▓ро╛, родрпЗроирпАро░рпН, родрпЛроЯрпНроЯроорпН, рокро┤роорпН, ро╡ро┐ро╡роЪро╛ропроорпН
ЁЯз╗	of, paper, roll, toilet, towel, towels, роХро╛роХро┐род, роЪрпБро░рпБро│рпН, роЯро╡ро▓рпН, роЯро╛ропрпНро▓рпЖроЯрпН, родрпБроЯрпИрокрпНрокро╛ройрпН, рокрпЗрокрпНрокро░рпН, рокрпКро░рпБро│рпН, ро░рпЛро▓рпН
ЁЯз╝	bar, bathing, clean, cleaning, lather, soap, soapdish, роХрпБро│ро┐ропро▓рпН, роЪрпБродрпНродроорпН, роЪрпЛрокрпН, роЪрпЛрокрпНрокрпБ, роЯрокрпНрокро╛, роирпБро░рпИ, рокрпКро░рпБро│рпН
ЁЯз╜	absorbing, cleaning, porou, porous, soak, sponge, роЙро▒ро┐роЮрпНроЪро┐, роЙро▒ро┐роЮрпНроЪрпБродро▓рпН, роЪрпБродрпНродроорпН, родрпБро│рпИроХро│рпН, рокрпКро░рпБро│рпН, ро╕рпНрокро╛роЮрпНроЪрпБ, ро╕рпНрокро╛ройрпНроЪрпН, ро╕рпНрокро╛ройрпНроЮрпН
ЁЯз╛	accounting, bookkeeping, evidence, invoice, proof, receipt, роЖродро╛ро░роорпН, роЗройрпНро╡ро╛ропрпНро╕рпН, роХрогроХрпНроХрпБро╡ро┤роХрпНроХрпБ, роЪро╛роЯрпНроЪро┐ропроорпН, роЪрпЖро▓ро╡рпБ, рокроЯрпНроЯро┐ропро▓рпН, рокрпКро░рпБро│рпН, ро░роЪрпАродрпБ, ро╡ро░ро╡рпБ, ро╡ро┐ро▓рпИ, ро╡ро┐ро▓рпИрокрпНрокроЯрпНроЯро┐ропро▓рпН
ЁЯз┐	amulet, bead, blue, charm, evil, eye, nazar, talisman, роЕро┤роХрпБ, роЖроорпБро▓роЯрпН, роХрогрпН, родропро╛родрпНродрпБ, родро╛ропродрпНродрпБ, родрпАроп, роиро╛роЪро░рпН, роиро╛роЬро░рпН, роирпАро▓роорпН, роорогро┐
ЁЯй░	ballet, dance, shoe, shoes, роХро╛ро▓рогро┐, роХро╛ро▓рогро┐роХро│рпН, роироЯройроорпН, рокро╛ро▓рпЗ
ЁЯй▒	bathing, one, piece, suit, swimsuit, роЖроЯрпИ, роХрпБро│ро┐ропро▓рпН, роЪрпВроЯрпН, роирпАроЪрпНроЪро▓рпН, ро╕рпНро╡ро┐роорпН
ЁЯй▓	bathing, brief, briefs, one, piece, suit, swimsuit, underwear, роЕрогрпНроЯро░рпНро╡рпЗро░рпН, роЕройрпНроЯро░рпНро╡рпЗро░рпН, роЖроЯрпИ, роЙро│рпНро│ро╛роЯрпИ, роХрпБро▒рпБроЩрпНроХро╛ро▓рпНроЪроЯрпНроЯрпИ, роХрпБро│ро┐ропро▓рпН, роЬроЯрпНроЯро┐, роирпАроЪрпНроЪро▓рпН, рокрпНро░рпАроГрокрпН
ЁЯй│	bathing, pant, pants, short, shorts, suit, swimsuit, underwear, роЕрогрпНроЯро░рпНро╡рпЗро░рпН, роЕройрпНроЯро░рпНро╡рпЗро░рпН, роЖроЯрпИ, роЙро│рпНро│ро╛роЯрпИ, роХро╛ро▓рпНроЪроЯрпНроЯрпИ, роХрпБро│ро┐ропро▓рпН, роЯро┐ро░роЩрпНроХрпН
ЁЯй┤	beach, flip, flop, sandal, sandals, shoe, thong, thongs, z┼Нri, роГрокрпНро│ро╛рокрпН, роГрокрпНро│ро┐рокрпН, роЪрпЖро░рпБрокрпНрокрпБ, роЪрпЖро░рпБрокрпНрокрпБроХро│рпН, роЪрпЛро░ро┐, родро╛роЩрпН, родро╛роЩрпНроХрпБроХро│рпН, рокрпАроЪрпН, ро╕рпНро▓ро┐рокрпНрокро░рпН
ЁЯй╕	bleed, blood, donation, drop, injury, medicine, menstruation, of, роЗро░родрпНрод, роЗро░родрпНродродрпН, роЗро░родрпНродроорпН, родро╛ройроорпН, родрпБро│ро┐, рооро░рпБроирпНродрпБро╡роорпН, рооро╛родро╡ро┐роЯро╛ропрпН
ЁЯй╣	adhesive, bandage, роОропрпНроЯрпН, роТроЯрпНроЯроХрпНроХрпВроЯро┐роп, роТроЯрпНроЯрпБроорпН, роХро╛ропроорпН, рокро╛рогрпНроЯрпЗроЬрпН, рокро╛рогрпНроЯрпН, рокрпЗрогрпНроЯрпЗроЬрпН
ЁЯй║	doctor, heart, medicine, stethoscope, роЗродропродрпНродрпБроЯро┐рокрпНрокрпБ, роЗродропроорпН, родрпБроЯро┐рокрпНрокрпБ, рооро░рпБродрпНродрпБро╡роорпН, рооро░рпБродрпНродрпБро╡ро░рпН, ро╕рпНроЯрпЖродро╕рпНроХрпЛрокрпН, ро╕рпНроЯрпЖродро╛ро╕рпНроХрпЛрокрпН
ЁЯй╗	bone, bones, doctor, medical, ray, skeleton, skull, xray, роОроХрпНро╕рпНро░рпЗ, роОро▓рпБроорпНрокрпБроХро│рпН, роОро▓рпБроорпНрокрпБроХрпНроХрпВроЯрпБ, рооро░рпБродрпНродрпБро╡роорпН, рооро░рпБродрпНродрпБро╡ро░рпН
ЁЯй╝	aid, cane, crutch, disability, help, hurt, injured, mobility, stick, роЗропро▓ро╛роорпИ, роЙродро╡ро┐, роКройрпНро▒рпБроХрпЛро▓рпН, роХро╛ропроорпН, роХрпБроЪрпНроЪро┐, роироХро░рпНро╡родро▒рпНроХро╛рой, рокро┐ро░роорпНрокрпБ
ЁЯкА	fluctuate, toy, yo, роЗро▒роХрпНроХроорпН, роПро▒рпНро▒, рокрпКроорпНроорпИ, рокрпКро┤рпБродрпБрокрпЛроХрпНроХрпБ, ропрпЛ, ропрпЛропрпЛ
ЁЯкБ	fly, kite, soar, роЙропро░рокрпНрокро▒родрпНродро▓рпН, рокроЯрпНроЯроорпН, рокро▒рокрпНрокродрпБ, рокрпКро┤рпБродрпБрокрпЛроХрпНроХрпБ
ЁЯкВ	glide, hang, parachute, parasail, skydive, роХрпНро│рпИроЯрпН, роЯрпИро╡рпН, рокро╛ро░ро╛роЪрпВроЯрпН, ро╕рпНроХрпИ, ро╣рпЗроЩрпНроХрпН
ЁЯкГ	boomerang, rebound, repercussion, weapon, роЖропрпБродроорпН, роЖро╕рпНродро┐ро░рпЗро▓ро┐ропро╛, родро┐ро░рпБроорпНрокро┐, рокрпВрооро░ро╛роЩрпНроХрпН, ро░рпАрокро╡рпБройрпНроЯрпН, ро╡ро░рпБродро▓рпН, ро╡ро┐ро│рпИропро╛роЯрпНроЯрпБ
ЁЯкД	magic, magician, wand, witch, wizard, роХрпЛро▓рпН, роЪрпВройро┐ропроХрпНроХро╛ро░ро┐, роороирпНродро┐ро░роХрпН, роороирпНродро┐ро░роХрпНроХрпЛро▓рпН, роороирпНродро┐ро░роорпН, роороирпНродро┐ро░ро╡ро╛родро┐, рооро╛ропро╛роЬро╛ро▓роорпН, роорпЗроЬро┐роХрпН
ЁЯкЕ	candy, celebrate, celebration, cinco, de, festive, mayo, party, pinada, pinata, pi├▒ata, роХрпКрогрпНроЯро╛роЯрпНроЯроорпН, родро┐ро░рпБро╡ро┐ро┤ро╛, рокро╛ро░рпНроЯрпНроЯро┐, рокро┐ройро╛роЯрпНроЯро╛, роорпЖроХрпНроЪро┐роХройрпН, ро╡ро┐ро┤ро╛
ЁЯкЖ	babooshka, baboushka, babushka, doll, dolls, matryoshka, nesting, russia, роЕроорпНрооро╛, рокрпКроорпНроорпИ, рокрпКроорпНроорпИроХро│рпН, ро░ро╖ро┐ропро╛, ро░ро╖рпНропро╛
ЁЯкЗ	cha, dance, instrument, maraca, maracas, music, party, percussion, rattle, shake, shaker, роЗроЪрпИ, роХро░рпБро╡ро┐, роХро┐ро▓рпБроХро┐ро▓рпБрокрпНрокрпИ, роХрпБро▓рпБроХрпНроХро▓рпН, роЪроХрпН, родро╛ро│, рокрпКро░рпБро│рпН, рооро░роХрпНроХро╛ро╕рпН, ро╡ро╛родрпНродро┐ропроорпН, ро╖рпЗроХрпНроХро░рпН
ЁЯкИ	band, fife, flautist, flute, instrument, marching, music, orchestra, piccolo, pipe, recorder, woodwind, роГрокрпИроГрокрпН, роЗроЪрпИ, роЗроЪрпИроХрпН, роХро░рпБро╡ро┐, роХро╛ройроорпН, роХро┐ро░рпБро╖рпНрогро░рпН, роХрпБро┤ро╛ропрпН, рокрпБро▓рпНро▓ро╛роЩрпНроХрпБро┤ро▓рпН, рооро░роХрпНроХро╛ро▒рпНро▒рпБ, ро░рпЖроХрпНроХро╛ро░рпНроЯро░рпН
ЁЯкЙ	cupid, harp, instrument, love, music, orchestra, роЗроЪрпИ, роЗроЪрпИроХрпНроХрпБро┤рпБ, роХро░рпБро╡ро┐, роХро╛родро▓рпН, рооройрпНроородройрпН, ропро╛ро┤рпН
ЁЯкП	bury, dig, garden, hole, plant, scoop, shovel, snow, spade, роХрпБроЯрпИро╡рпБроХрпНроХро░рпБро╡ро┐, роХрпБро┤ро┐, роХрпБро┤ро┐ро╡рпЖроЯрпНроЯро┐, родрпЛрогрпНроЯро▓рпН, роорогрпНро╡рпЖроЯрпНроЯро┐
ЁЯкР	planet, ringed, saturn, saturnine, роЙро│рпНро│, роХро┐ро░роХроорпН, роХрпЛро│рпН, роЪройро┐, ро╡ро│рпИропроорпН
ЁЯкС	chair, seat, sit, роЗро░рпБроХрпНроХрпИ, роЙроЯрпНроХро╛ро░рпБродро▓рпН, роЪрпАроЯрпН, роЪрпЗро░рпН, роиро╛ро▒рпНроХро╛ро▓ро┐, рооро░
ЁЯкТ	razor, sharp, shave, роХрпВро░рпНроорпЖройрпНроХродрпНродро┐, роЪро╡ро░роХрпНроХродрпНродро┐, рокро┐ро│рпЗроЯрпБ, ро░рпЗроЪро░рпН, ро░рпЗро╕ро░рпН, ро╖рпЗро╡ро░рпН, ро╖рпЗро╡рпН
ЁЯкУ	ax, axe, chop, hatchet, split, wood, роХрпЛроЯро╛ро░ро┐, роХрпЛроЯро╛ро▓ро┐, рооро░роХрпНроХроЯрпНроЯрпИ, рооро░роорпН, ро╡рпЖроЯрпНроЯрпБ, ро╡рпЖроЯрпНроЯрпБродро▓рпН
ЁЯкФ	diya, lamp, light, oil, роЕроХро▓рпН, роОрогрпНрогрпЖропрпН, роХро╛ро░рпНродрпНродро┐роХрпИ, роЬрпЛродро┐, ро╡ро┐ро│роХрпНроХрпБ
ЁЯкХ	banjo, music, stringed, роЗроЪрпИ, роРроирпНродрпБ, роХро░рпБро╡ро┐, родроирпНродро┐роХрпНроХро░рпБро╡ро┐, роиро░роорпНрокрпБроХрпН, рокро╛роЮрпНроЪрпЛ, рокро╛ройрпНроЬрпЛ
ЁЯкЦ	army, helmet, military, soldier, war, warrior, родро▓рпИроХрпНроХро╡роЪроорпН, рокрпЛро░рпН, рооро┐ро▓ро┐роЯрпНроЯро░ро┐, ро░ро╛рогрпБро╡, ро░ро╛рогрпБро╡родрпН, ро░ро╛рогрпБро╡роорпН, ро╡рпАро░ро░рпН
ЁЯкЧ	accordion, box, concertina, instrument, music, squeeze, squeezebox, роЕроХрпНроХро╛ро░рпНроЯро┐ропройрпН, роЕро┤рпБродрпНродрпБроорпН, роЗроЪрпИ, роЗроЪрпИроХрпНроХро░рпБро╡ро┐, роЗроЪрпИрокрпН, роХро╛ройрпНроЪрпЖро░рпНроЯро┐ройро╛, рокрпЖроЯрпНроЯро┐
ЁЯкШ	beat, conga, drum, instrument, long, rhythm, роЗроЪрпИ, роЗроЪрпИроХрпНроХро░рпБро╡ро┐, роХрпКроЯрпНроЯрпБ, роХрпЛроЩрпНроХро╛, родро╛ро│роорпН, роирпАрогрпНроЯ, рокро▒рпИ, роородрпНродро│роорпН, ро░ро┐родроорпН
ЁЯкЩ	coin, dollar, euro, gold, metal, money, rich, silver, treasure, роЙро▓рпЛроХроорпН, роХро╛роЪрпБ, родроЩрпНроХроорпН, роиро╛рогропроорпН, рокрогроорпН, рокрпБродрпИропро▓рпН, ро╡рпЖро│рпНро│ро┐
ЁЯкЪ	carpenter, carpentry, cut, lumber, saw, tool, trim, роХро░рпБро╡ро┐, роХрпКро▓рпИ, родроЪрпНроЪро░рпН, ро░роорпНрокроорпН, ро▓роорпНрокро░рпН, ро╡рпЖроЯрпНроЯрпБ
ЁЯкЫ	flathead, handy, screw, screwdriver, tool, роХро░рпБро╡ро┐, родро┐ро░рпБрокрпНрокрпБро│ро┐, ро╕рпНроХрпНро░рпВроЯро┐ро░рпИро╡ро░рпН
ЁЯкЬ	climb, ladder, rung, step, роПрогро┐, роПрогро┐рокрпНрокроЯро┐, роПройро┐рокрпНрокроЯро┐, роПро▒рпБродро▓рпН, рокроЯро┐
ЁЯкЭ	catch, crook, curve, ensnare, hook, point, selling, роЗроЯроорпН, роХрпКроХрпНроХро┐, рокро┐роЯро┐родрпНродро▓рпН, рооро╛роЯрпНроЯро┐, ро╡ро│рпИро╡рпБ, ро╡ро┐ро▒рокройрпИ, ро╣рпВроХрпН
ЁЯкЮ	makeup, mirror, reflection, reflector, speculum, роЙро▓рпЛроХроорпН, роТрокрпНрокройрпИ, роХрогрпНрогро╛роЯро┐, рокро┐роорпНрокроорпН, рокро┐ро░родро┐рокро▓ро┐рокрпНрокро╛ройрпН, рокро┐ро░родро┐рокро▓ро┐рокрпНрокрпБ, рооро┐ро░ро░рпН, роорпЖро░рпБроХрпЗро▒рпНро▒рокрпНрокроЯрпНроЯ, роорпЗроХрпНроХрокрпН
ЁЯкЯ	air, frame, fresh, opening, transparent, view, window, роТро│ро┐рокрпНрокрпБроХрпБроорпН, роХро╛роЯрпНроЪро┐, роХро╛ро▒рпНро▒рпБ, роЪроЯрпНроЯроорпН, роЬройрпНройро▓рпН, родройрпНроорпИ, родро┐ро▒рокрпНрокрпБ, родрпВропрпНроорпИропро╛рой
ЁЯка	cup, force, plumber, plunger, poop, suction, toilet, роЙро▒ро┐роЮрпНроЪрпБродро▓рпН, роЙро▒ро┐ропрпБроорпН, роХрокрпН, роХро┤ро┐ро╡ро▒рпИ, роЪроХрпНро╖ройрпН, рокрпНро│роЩрпНроХро░рпН, рокрпНро│роорпНрокро░рпН
ЁЯкб	embroidery, needle, sew, sewing, stitche, stitches, suture, sutures, tailoring, thread, роКроЪро┐, роОроорпНрокро┐ро░ро╛ропрпНроЯро░ро┐, роЯрпЖропрпНро▓ро░ро┐роЩрпН, родрпИродрпНродро▓рпН, родрпИропро▓рпН
ЁЯкв	cord, knot, rope, tangled, tie, twine, twist, роХроЯрпНроЯрпБ, роХропро┐ро▒рпБ, роЪро┐роХрпНроХро▓рпН, роирпВро▓рпН, роорпБроЯро┐роЪрпНроЪрпБ, роорпБро▒рпБроХрпНроХрпБ
ЁЯкг	bucket, cask, pail, vat, роХрпБро│ро┐ропро▓рпН, рокроХрпНроХрпЖроЯрпН, рокрпАрокрпНрокро╛ропрпН, ро╡ро╛ро│ро┐
ЁЯкд	bait, cheese, lure, mouse, mousetrap, snare, trap, роОро▓ро┐, роОро▓ро┐рокрпНрокрпКро▒ро┐, родрпВрогрпНроЯро┐ро▓рпН, рокрпКро▒ро┐, ро╡ро▓рпИ
ЁЯке	bathroom, brush, clean, dental, hygiene, teeth, toiletry, toothbrush, роХрпБро│ро┐ропро▓ро▒рпИ, роЪрпБроХро╛родро╛ро░роорпН, роЪрпБродрпНродроорпН, роЯрпВродрпНрокро┐ро░ро╖рпН, роЯрпЖрогрпНроЯрпНроЯро▓рпН, роЯрпЖройрпНроЯро▓рпН, рокро▒рпНроХро│рпН, рокро▓рпН, рокро┐ро░ро╖рпН
ЁЯкж	cemetery, dead, grave, graveyard, headstone, memorial, rip, tomb, tombstone, роЗро▒рокрпНрокрпБ, роХро▓рпНро▓ро▒рпИ, роХро▓рпНро▓ро▒рпИроХрпНроХро▓рпН, роЪрооро╛родро┐, рооропро╛ройроорпН
ЁЯкз	card, demonstration, notice, picket, placard, plaque, protest, роЖро░рпНрокро╛роЯрпНроЯроорпН, роХрпБро▒ро┐ропрпАроЯрпБ, рокродро╛роХрпИ, рокрпЛро░ро╛роЯрпНроЯроорпН, рооро▒ро┐ропро▓рпН
ЁЯки	boulder, heavy, rock, solid, stone, tough, роХройроорпН, роХро▓рпН, родро┐роЯроорпН, рокро╛ро▒ро╛роЩрпНроХро▓рпН, рокро╛ро▒рпИ
ЁЯкй	ball, dance, disco, glitter, mirror, party, роЙро░рпБрогрпНроЯрпИ, роХрогрпНрогро╛роЯро┐, роХрпКрогрпНроЯро╛роЯрпНроЯроорпН, роЯро┐ро╕рпНроХрпЛ, роироЯройроорпН, рокроирпНродрпБ, рокро╛ро░рпНроЯрпНроЯро┐, рооро┐ройрпБрооро┐ройрпБрокрпНрокрпБ
ЁЯкк	card, credential, credentials, document, id, identification, license, security, роЕроЯрпИропро╛ро│, роЕроЯрпИропро╛ро│роорпН, роЕроЯрпНроЯрпИ, роЖро╡рогроорпН, роЙро░ро┐роороорпН, роРроЯро┐, роЪро╛ройрпНро▒рпБроХро│рпН, рокро╛родрпБроХро╛рокрпНрокрпБ
ЁЯкл	battery, drained, electronic, energy, low, power, роЖро▒рпНро▒ро▓рпН, роХро╛ро▓ро┐, роХрпБро▒рпИроирпНрод, рокрпЗроЯрпНроЯро░ро┐, рооро┐ройрпНройрогрпБ
ЁЯкм	amulet, fatima, fortune, guide, hamsa, hand, mary, miriam, palm, protect, protection, роЕродро┐ро░рпНро╖рпНроЯроорпН, роЙро│рпНро│роЩрпНроХрпИ, роХрпИ, родро╛ропродрпНродрпБ, рокро╛родрпБроХро╛рокрпНрокрпБ, рокро╛родрпНродро┐рооро╛, рооро┐ро░ро┐ропроорпН, роорпЗро░ро┐, ро╡ро┤ро┐роХро╛роЯрпНроЯро┐, ро╣роорпНроЪро╛
ЁЯкн	clack, clap, cool, cooling, dance, fan, flirt, flutter, folding, hand, hot, shy, роГрокрпЗройрпН, роХро╛ро▒рпНро▒рпБ, роХрпБро│ро┐ро░рпНроЪрпНроЪро┐, роХрпИ, роЪро┐ро▒роХроЯро┐рокрпНрокрпБ, роЬрокрпНрокро╛ройрпН, роироЯройроорпН, рокройрпИ, роороЯро┐рокрпНрокрпБ, ро╡ро┐роЪро┐ро▒ро┐, ро╡рпЖроЯрпНроХроорпН, ро╡рпЖрокрпНрокроорпН
ЁЯко	afro, comb, groom, hair, pick, роЕро▓роЩрпНроХро╛ро░роорпН, роЖроГрокрпНро░рпЛ, роХрпВроирпНродро▓рпН, роЪро┐роХрпИ, роЪрпАрокрпНрокрпБ, рокро┐роХрпН, роорпБроЯро┐, ро╣рпЗро░рпН
ЁЯк░	animal, disease, fly, insect, maggot, pest, rotting, роЕро┤рпБроХрпБродро▓рпН, роирпЛропрпН, рокрпБро┤рпБ, рокрпВроЪрпНроЪро┐
ЁЯк▒	animal, annelid, earthworm, parasite, worm, роТроЯрпНроЯрпБрогрпНрогро┐, рокрпБро┤рпБ, роорогрпНрокрпБро┤рпБ, ро╡ро┐ро▓роЩрпНроХрпБ
ЁЯк▓	animal, beetle, bug, insect, роХроЯро┐, рокроХрпН, рокрпВроЪрпНроЪро┐, ро╡рогрпНроЯрпБ, ро╡ро┐ро▓роЩрпНроХрпБ
ЁЯк│	animal, cockroach, insect, pest, roach, роХро░рокрпНрокро╛ройрпН, роХро╛роХрпНро░рпЛроЪрпН, рокрпВроЪрпНроЪро┐
ЁЯк┤	decor, grow, house, nurturing, plant, pot, potted, роЕро▓роЩрпНроХро╛ро░роорпН, роЪрпЖроЯро┐, рокро╛ройрпИ, ро╡ро│ро░рпНродрпНродро▓рпН, ро╡рпАроЯрпБ
ЁЯк╡	log, lumber, timber, wood, роХроЯрпНроЯрпИ, родрпБрогрпНроЯрпБ, рооро░роХрпНроХроЯрпНроЯрпИ, рооро░родрпН, рооро░роорпН
ЁЯк╢	bird, feather, flight, light, plumage, роЗро▒роХрпБ, роЗро▒роХрпНроХрпИ, родрпЛроХрпИ, рокро▒родрпНродро▓рпН, рокро▒ро╡рпИ, ро▓рпЗроЪро╛рой
ЁЯк╖	beauty, buddhism, calm, flower, hinduism, lotu, lotus, peace, purity, serenity, роЕроорпИродро┐, роЕро┤роХрпБ, роЗроирпНродро┐ропро╛, роЗроирпНродрпБ, родро╛рооро░рпИ, родрпВропрпНроорпИ, рокрпМродрпНродроорпН, роородроорпН, рооро▓ро░рпН, ро╡ро┐ропроЯрпНроиро╛роорпН
ЁЯк╕	change, climate, coral, ocean, reef, sea, роХроЯро▓рпН, роХро╛ро▓роиро┐ро▓рпИ, роирпАро░роЯро┐родрпНродро┐роЯрпНроЯрпБ, рокро╡ро│роорпН, рокро╛ро▒рпИ, рооро╛ро▒рпНро▒роорпН
ЁЯк╣	branch, empty, home, nest, nesting, роХроЯрпНроЯрпБродро▓рпН, роХро╛ро▓ро┐ропро╛рой, роХро┐ро│рпИ, роХрпВроЯрпБ, ро╡рпАроЯрпБ
ЁЯк║	bird, branch, egg, eggs, nest, nesting, роЙро│рпНро│, роХроЯрпНроЯрпБродро▓рпН, роХро┐ро│рпИ, роХрпВроЯрпБ, роорпБроЯрпНроЯрпИ, роорпБроЯрпНроЯрпИроХро│рпН, ро╡рпАроЯрпБ
ЁЯк╗	bloom, bluebonnet, flower, hyacinth, indigo, lavender, lilac, lupine, plant, purple, shrub, snapdragon, spring, violet, роКродро╛, рокродрпБрооро░ро╛роХроорпН, рокрпБро│рпВрокро╛ройрпЖроЯрпН, рокрпВ, рооро▓ро░рпН, ро▓ро╛ро╡рогрпНроЯро░рпН, ро▓ро╛ро╡рпЖрогрпНроЯро░рпН, ро▓рпВрокро┐ройрпН, ро╡рпЖроЩрпНроХро╛ропродрпНродро╛рооро░рпИ, ро╕рпНройро╛рокрпНроЯро┐ро░ро╛роХройрпН
ЁЯк╝	animal, aquarium, burn, invertebrate, jelly, jellyfish, life, marine, ocean, ouch, plankton, sea, sting, stinger, tentacle, tentacles, роЕроХрпНро╡рпЗро░ро┐ропроорпН, роЕроЯроЯро╛, роОро░ро┐родро▓рпН, роХроЯро▓рпН, роХрпКроЯрпНроЯрпБро╡родрпБ, роЪро╛ро░рпНроирпНродродрпБ, роЬрпЖро▓рпНро▓ро┐, роЬрпЖро▓рпНро▓ро┐роорпАройрпН, роорпБродрпБроХрпЖро▓рпБроорпНрокро┐ро▓рпНро▓ро╛родродрпБ, ро╡ро┐ро▓роЩрпНроХрпБ
ЁЯк╜	angelic, ascend, aviation, bird, fly, flying, heavenly, mythology, soar, wing, роЕроорпИродро┐, роЗро▒роХрпНроХрпИ, роЪрооро╛родро╛ройроорпН, родрпЗро╡родрпИ, родрпКройрпНрооро╡ро┐ропро▓рпН, рокро▒рокрпНрокродрпБ, рокро▒рокрпНрокро┐ропро▓рпН, рокро▒ро╡рпИ
ЁЯк╛	bare, barren, branche, branches, dead, drought, leafles, leafless, tree, trunk, winter, wood, роЗро▓рпИ, роЙродро┐ро░рпНроирпНрод, роХро╛ропрпНроирпНрод, родро░ро┐роЪрпБ, рокройро┐, рооро░роорпН
ЁЯк┐	animal, bird, duck, flock, fowl, gaggle, gander, geese, goose, honk, ornithology, silly, роЕройрпНройроорпН, роХрпБроЮрпНроЪрпБ, роХрпБро╡ро╛, роХрпВроЪрпНроЪро▓рпН, рокро▒ро╡рпИ, рокрпЖро░ро┐роп, роороЯроорпИ, ро╡ро│ро░рпНрокрпНрокрпБрокрпН, ро╡ро╛родрпНродро┐ройрпН, ро╡ро╛родрпНродрпБ, ро╡ро╛родрпНродрпБроХрпН
ЁЯлГ	belly, bloated, full, man, overeat, pregnant, роЕро│ро╡рпБроХрпНроХрпБ, роЖрогрпН, роЙрогро╡рпБрокрпН, роХро░рпБродрпНродро░ро┐родрпНродрпБро│рпНро│, роХро░рпБродрпНродро░ро┐рокрпНрокрпБ, роХро░рпНрокрпНрокроорпН, роЪро╛рокрпНрокро╛роЯрпНроЯрпБро░ро╛рооройрпН, роЪро╛рокрпНрокро┐роЯрпБродро▓рпН, родрпКрокрпНрокрпИ, роиро┐ро░роорпНрокро┐роп, рокро┐ро░ро┐ропро░рпН, роорпАро▒ро┐, ро╡ропро┐ро▒рпБ, ро╡рпАроЩрпНроХро┐роп
ЁЯлД	belly, bloated, full, overeat, person, pregnant, stuffed, роЕродро┐роХрооро╛роХ, роЕро│ро╡рпБроХрпНроХрпБ, роЙрогро╡рпБрокрпН, роХро░рпБродрпНродро░ро┐родрпНродрпБро│рпНро│, роХро░рпБродрпНродро░ро┐рокрпНрокрпБ, роХро░рпНрокрпНрокроорпН, роХро░рпНрокрпНрокро┐рогро┐, роЪро╛рокрпНрокро╛роЯрпНроЯрпБ, роЪро╛рокрпНрокро┐роЯрпБродро▓рпН, родрпКрокрпНрокрпИ, роирокро░рпН, роиро┐ро░роорпНрокро┐роп, рокро┐ро░ро┐ропро░рпН, ро░ро╛рооройрпН, ро╡ропро┐ро▒рпБ, ро╡рпАроЩрпНроХро┐роп
ЁЯлЕ	crown, monarch, noble, person, regal, royal, royalty, роЕрогро┐роирпНрод, роЕро░роЪройрпН, роЕро░роЪро░рпНроХрпНроХрпБро░ро┐ропро╡ро░рпН, роЕро░роЪрпБ, роХро┐ро░рпАроЯроорпН, роирокро░рпН, рокродро╡ро┐, роороХрпБроЯроорпН, роорпЗройрпНроорпИропро╛ройро╡ро░рпН, ро░ро╛роЬро╛, ро░ро╛рогро┐, ро░ро╛ропро▓рпНроЯро┐
ЁЯлО	alce, alces, animal, antler, antlers, elk, mammal, moose, роОро▓рпНроХрпН, роХроЯрооро╛ройрпН, роХрпКроорпНрокрпБроХро│рпН, рокро╛ро▓рпВроЯрпНроЯро┐, роорпВро╕рпН, ро╡ро┐ро▓роЩрпНроХрпБ
ЁЯлП	animal, ass, burro, donkey, hinny, mammal, mule, stubborn, роХро┤рпБродрпИ, роХрпЛро╡рпЗро▒ро┐роХрпНроХро┤рпБродрпИ, роЪроХро┐рокрпНрокрпБродрпНродройрпНроорпИ, роЪро┐ро▒рпБ, роЪрпБроорпИ, рокро╛ро▓рпВроЯрпНроЯро┐, рокро┐роЯро┐ро╡ро╛родрооро╛ройродрпБ, роороирпНродроорпН, ро╡ро┐ро▓роЩрпНроХрпБ
ЁЯлР	berries, berry, bilberry, blue, blueberries, blueberry, food, fruit, роЙрогро╡рпБ, рокро┤роорпН, рокро┐ро▓рпНрокрпЖро░рпНро░ро┐, рокрпЖро░рпНро░ро┐, рокрпНро│рпВ, рокрпНро│рпВрокрпЖро░рпНро░ро┐, рокрпНро│рпВрокрпЖро░рпНро░ро┐роХро│рпН
ЁЯлС	bell, capsicum, food, pepper, vegetable, роЙрогро╡рпБ, роХро╛ропрпН, роХрпБроЯрпИ, рокрпЖрокрпНрокро░рпН, рокрпЖро▓рпН, рооро┐ро│роХро╛ропрпН
ЁЯлТ	food, olive, роЖро▓ро┐ро╡рпН, роЙрогро╡рпБ
ЁЯлУ	arepa, bread, flatbread, food, gordita, lavash, naan, pita, роГрокро┐ро│ро╛роЯрпН, роЕро░рпЗрокро╛, роЙрогро╡рпБ, роиро╛ройрпН, рокро┐роЯро╛, рокро┐ро░роЯрпН, ро▓ро╛ро╡ро╛ро╖рпН
ЁЯлФ	food, mexican, pamonha, tamale, wrapped, роЙрогро╡рпБ, роЪрпБро▒рпНро▒рокрпНрокроЯрпНроЯродрпБ, родрооро╛ро▓рпЗ, рокроорпЛройрпНро╣ро╛, роорпЖроХрпНроЪро┐роХройрпН
ЁЯлХ	cheese, chocolate, fondue, food, melted, pot, ski, роГрокро╛рогрпНроЯрпВ, роЙрогро╡рпБ, роЙро░рпБроХро┐ропродрпБ, роХрпБро╡ро│рпИ, роЪро╛роХрпНроХро▓рпЗроЯрпН, роЪрпБро╡ро┐ро╕рпН, рокро╛ро▓ро╛роЯрпИроХрпНроХроЯрпНроЯро┐
ЁЯлЦ	brew, drink, food, pot, tea, teapot, роЙрогро╡рпБ, роХрпБро╡ро│рпИ, роЯрпА, родрпЗроирпАро░рпН, родрпЗроирпАро░рпНроХрпН, родрпЗройрпАро░рпН, рокро╛ройроорпН
ЁЯлЧ	accident, drink, empty, glas, glass, liquid, oop, oops, pour, pouring, spill, water, роЕроЪрпНроЪроЪрпНроЪрпЛ, роКро▒рпНро▒рпБ, роКро▒рпНро▒рпБродро▓рпН, роХроЪро┐ро╡рпБ, роХрогрпНрогро╛роЯро┐, роХро╛ро▓ро┐, роХрпБро╡ро│рпИ, роЪро┐роирпНродрпБродро▓рпН, родрогрпНрогрпАро░рпН, родро┐ро░ро╡родрпНродрпИ, роирпАро░рпН, рокро╛ройроорпН, ро╡ро┐рокродрпНродрпБ
ЁЯлШ	bean, beans, food, kidney, legume, small, роЙрогро╡рпБ, роХро╛ро░ро╛роорогро┐, роХрпБро▒рпИро╡рпБ, роЪро┐ро▒ро┐родрпБ, роЪро┐ро▒рпБроирпАро░роХроорпН, рокропро▒рпБ, рокропро▒рпБро╡роХрпИ, рокрпАройрпНро╕рпН, ро░ро╛роЬрпНрооро╛
ЁЯлЩ	condiment, container, empty, jar, nothing, sauce, store, роКро▒рпБроХро╛ропрпН, роТройрпНро▒рпБрооро┐ро▓рпНро▓рпИ, роХро│роЮрпНроЪро┐ропроорпН, роХро╛ро▓ро┐, роХрпКро│рпНроХро▓ройрпН, роЪро╛ро╕рпН, роЬро╛роЯро┐
ЁЯлЪ	beer, ginger, health, herb, natural, root, spice, роЗроЮрпНроЪро┐, роЬро┐роЮрпНроЪро░рпН, роЯрпА, рокрпАро░рпН, роороЪро╛ро▓ро╛, роорпВро▓ро┐роХрпИ, ро╡рпЗро░рпН
ЁЯлЫ	bean, beans, beanstalk, edamame, legume, pea, pod, soybean, vegetable, veggie, роОроЯрооро╛роорпН, роХро╛ропрпН, роХро╛ропрпНроХро▒ро┐, роХро┐ро░рпАройрпН, рокроЪрпНроЪрпИрокрпН, рокроЯрпНроЯро╛рогро┐, рокро░рпБрокрпНрокрпБ, рокрпАройрпНро╕рпН, рокрпАро╕рпН, ро╡роХрпИ
ЁЯлЬ	beet, food, garden, radish, root, salad, turnip, vegetable, vegetarian, роХро╛ропрпНроХро▒ро┐, родрпЛроЯрпНроЯроорпН, роирпВро▓рпНроХрпЛро▓рпН, рокрпАроЯрпН, ро╡рпЗро░рпН
ЁЯлз	bubble, bubbles, burp, clean, floating, pearl, soap, underwater, роХрпБрооро┐ро┤ро┐, роХрпБрооро┐ро┤ро┐роХро│рпН, роХрпБрооро┐ро┤рпНроХро│рпН, роЪрпБродрпНродроорпН, роЪрпЛрокрпНрокрпБ, роирпАро░рпБроХрпНроХроЯро┐ропро┐ро▓рпН, рооро┐родродрпНродро▓рпН, роорпБродрпНродрпБ
ЁЯЪА	launch, rocket, rockets, space, travel, роПро╡рпБроХрогрпИ, роЪрпЛродройрпИ, ро░ро╛роХрпНроХрпЖроЯрпН, ро╡ро┐рогрпНро╡рпЖро│ро┐
ЁЯЪБ	copter, helicopter, roflcopter, travel, vehicle, рокропрогроорпН, ро╡ро╛ройрпНро╡ро┤ро┐рокрпН, ро╡ро┐роРрокро┐, ро╣рпЖро▓ро┐роХро╛рокрпНроЯро░рпН
ЁЯЪВ	caboose, engine, locomotive, railway, steam, train, trains, travel, роОроЮрпНроЪро┐ройрпН, родрпКроЯро░рпН, роирпАро░ро╛ро╡ро┐, рокропрогроорпН, рокрпБроХрпИ, ро╡рогрпНроЯро┐
ЁЯЪГ	car, electric, railway, train, tram, travel, trolleybu, trolleybus, роЗро░ропро┐ро▓рпН, рооро┐ройрпНроЪро╛ро░, ро░ропро┐ро▓рпН, ро╡рогрпНроЯро┐
ЁЯЪД	high, railway, shinkansen, speed, train, роЗро░ропро┐ро▓рпН, ро░ропро┐ро▓рпН, ро╡рогрпНроЯро┐, ро╡ро┐ро░рпИро╡рпБ
ЁЯЪЕ	bullet, high, nose, railway, shinkansen, speed, train, travel, роЗро░ропро┐ро▓рпН, рокрпБро▓рпНро▓роЯрпН, рокрпБро▓рпНро▓рпЖроЯрпН, ро░ропро┐ро▓рпН, ро╡рогрпНроЯро┐
ЁЯЪЖ	arrived, choo, railway, train, роЗро░ропро┐ро▓рпН, роЯро┐ро░рпЖропро┐ройрпН, роорпЖроЯрпНро░рпЛ, ро░ропро┐ро▓рпН, ро░ропро┐ро▓рпНро╡рпЗ, ро╡рогрпНроЯро┐
ЁЯЪЗя╕П	metro, subway, travel, роЗро░ропро┐ро▓рпН, роЪрокрпНро╡рпЗ, роЯро┐ро░рпЖропро┐ройрпН, роорпЖроЯрпНро░рпЛ, ро░ропро┐ро▓рпН, ро╡рогрпНроЯро┐, ро╡ро╛роХройроорпН
ЁЯЪИ	arrived, light, monorail, rail, railway, роЗро░ропро┐ро▓рпН, роорпЛройрпЛро░ропро┐ро▓рпН, ро░ропро┐ро▓рпН, ро░ропро┐ро▓рпНро╡рпЗ, ро▓рпИроЯрпН, ро╡роирпНродроЯрпИроирпНродродрпБ
ЁЯЪЙ	railway, station, train, роЗро░ропро┐ро▓рпН, роЯро┐ро░рпЖропро┐ройрпН, роиро┐ро▒рпБродрпНродроорпН, роиро┐ро▓рпИропроорпН, ро░ропро┐ро▓рпН
ЁЯЪК	tram, trolleybu, trolleybus, роЯро┐ро░ро╛роорпН, роЯро┐ро░ро╛ро▓ро┐, рокро╕рпН, ро╡рогрпНроЯро┐, ро╡ро╛роХройроорпН
ЁЯЪЛ	bus, car, tram, trolley, trolleybu, trolleybus, роХро╛ро░рпН, роХрпКро▓рпНроХродрпНродро╛, роЯро┐ро░ро╛роорпН, ро╡ро╛роХройроорпН
ЁЯЪМ	bus, school, vehicle, рокро│рпНро│ро┐, рокро╕рпН, рокрпЗро░рпБроирпНродрпБ, ро╡ро╛роХройроорпН
ЁЯЪНя╕П	bus, car, cars, oncoming, рокро╕рпН, рокрпЗро░рпБроирпНродрпБ, ро╡роирпНродрпБроХрпКрогрпНроЯро┐ро░рпБроХрпНроХро┐ро▒родрпБ, ро╡роирпНродрпБроХрпКрогрпНроЯро┐ро░рпБроХрпНроХрпБроорпН
ЁЯЪО	bus, tram, trolley, trolleybu, trolleybus, роЯро┐ро░ро╛роорпН, роЯро┐ро░ро╛ро▓ро┐, роЯрпНро░ро╛ро▓ро┐рокро╕рпН, рокро╕рпН, рооро┐ройрпНроЪро╛ро░
ЁЯЪП	bus, busstop, stop, роиро┐ро▒рпБродрпНродроорпН, рокро╕рпН, рокрпЗро░рпБроирпНродрпБ, ро╕рпНроЯро╛рокрпН, ро╕рпНроЯро╛рокрпНрокро┐роЩрпН
ЁЯЪР	bus, drive, minibu, minibus, van, vehicle, роЪро┐ро▒рпНро▒рпБроирпНродрпБ, рокро╕рпН, рооро┐ройро┐, ро╡ро╛роХройроорпН, ро╡рпЗройрпН
ЁЯЪСя╕П	108, ambulance, emergency, vehicle, роЕро╡роЪро░роорпН, роЖроорпНрокрпБро▓ройрпНро╕рпН, роЙродро╡ро┐, роОрооро░рпНроЬрпЖройрпНроЪро┐, рооро░рпБродрпНродрпБро╡, ро╡ро╛роХройроорпН, ро╡ро┐рокродрпНродрпБ
ЁЯЪТ	engine, fire, truck, роЯро┐ро░роХрпН, родрпА, родрпАропрогрпИрокрпНрокрпБ, ро╡рогрпНроЯро┐, ро╡ро╛роХройроорпН
ЁЯЪУ	car, cop, cops, patrol, police, роХро╛ро░рпН, роХро╛ро╡ро▓рпНродрпБро▒рпИ, рокрпЛро▓рпАро╕рпН, ро░рпЛроирпНродрпБ, ро╡рогрпНроЯро┐, ро╡ро╛роХройроорпН
ЁЯЪФя╕П	car, oncoming, police, роХро╛ро░рпН, роХро╛ро╡ро▓рпНродрпБро▒рпИ, рокрпЛро▓рпАро╕рпН, ро╡рогрпНроЯро┐, ро╡роирпНродрпБроХрпКрогрпНроЯро┐ро░рпБроХрпНроХро┐ро▒родрпБ, ро╡роирпНродрпБроХрпКрогрпНроЯро┐ро░рпБроХрпНроХрпБроорпН, ро╡ро╛роХройроорпН
ЁЯЪХ	cab, cabbie, car, drive, taxi, vehicle, yellow, роКрокро░рпН, роУро▓ро╛, роХрпЗрокрпН, роЯро╛роХрпНроЪро┐, роЯро╛роХрпНро╕ро┐
ЁЯЪЦ	cab, cabbie, car, cars, drove, hail, oncoming, taxi, yellow, роКрокро░рпН, роУро▓ро╛, роХрпЗрокрпН, роЯро╛роХрпНроЪро┐, роЯро╛роХрпНро╕ро┐, ро╡роирпНродрпБроХрпКрогрпНроЯро┐ро░рпБроХрпНроХрпБроорпН, ро╡ро╛роЯроХрпИ
ЁЯЪЧ	automobile, car, driving, vehicle, роЖроЯрпНроЯрпЛроорпКрокрпИро▓рпН, роХро╛ро░рпН, роорпЛроЯрпНроЯро╛ро░рпН, ро╡рогрпНроЯро┐, ро╡ро╛роХройроорпН
ЁЯЪШя╕П	automobile, car, cars, drove, oncoming, vehicle, роЖроЯрпНроЯрпЛроорпКрокрпИро▓рпН, роХро╛ро░рпН, роорпЛроЯрпНроЯро╛ро░рпН, ро╡рогрпНроЯро┐, ро╡роирпНродрпБроХрпКрогрпНроЯро┐ро░рпБроХрпНроХро┐ро▒родрпБ, ро╡роирпНродрпБроХрпКрогрпНроЯро┐ро░рпБроХрпНроХрпБроорпН, ро╡ро╛роХройроорпН
ЁЯЪЩ	car, drive, recreational, sport, sportutility, utility, vehicle, роОро╕рпН, роХрпКрогрпНроЯ, роиро╡рпАрой, рокрпЗро░рпБроирпНродрпБ, ропрпБ, ропрпВроЯрпНроЯро┐ро▓ро┐роЯрпНроЯро┐, ро╡роЪродро┐роХро│рпН, ро╡ро╛роХройроорпН, ро╡ро┐, ро╕рпНрокрпЛро░рпНроЯрпН
ЁЯЪЪ	car, delivery, drive, truck, vehicle, роЪро░роХрпНроХрпБ, роЯро┐ро░роХрпН, роЯрпЖро▓ро┐ро╡ро░ро┐, ро▓ро╛ро░ро┐, ро╡рогрпНроЯро┐, ро╡ро╛роХройроорпН
ЁЯЪЫ	articulated, car, drive, lorry, move, semi, truck, vehicle, роХройро░роХ, роЪро░роХрпНроХрпБ, роЯро┐ро░роХрпН, рокро╛ро░рпНроЪро▓рпН, рокрпЗроХрпНроХро░рпНро╕рпН, роорпВро╡ро░рпНро╕рпН, ро▓ро╛ро░ро┐, ро╡ро╛роХройроорпН
ЁЯЪЬ	tractor, vehicle, роЯро┐ро░ро╛роХрпНроЯро░рпН, ро╡рогрпНроЯро┐, ро╡ро╛роХройроорпН, ро╡ро┐ро╡роЪро╛ропроорпН
ЁЯЪЭ	monorail, vehicle, роорпЛройрпЛро░ропро┐ро▓рпН, ро╡рогрпНроЯро┐, ро╡ро╛роХройроорпН
ЁЯЪЮ	car, mountain, railway, trip, роирпАро▓роХро┐ро░ро┐, рокропрогроорпН, рокро╛родрпИ, рооро▓рпИ, рооро▓рпИрокрпН, ро░ропро┐ро▓рпН
ЁЯЪЯ	railway, suspension, роЗро░ропро┐ро▓рпН, родрпКроЩрпНроХрпБ, ро░ропро┐ро▓рпН, ро░ропро┐ро▓рпНрокро╛родрпИ
ЁЯЪа	cable, cableway, gondola, lift, mountain, ski, роХрпЗрокро┐ро│рпН, роХрпЗрокро┐ро│рпНро╡ро┤ро┐, роХрпКрогрпНроЯрпЛро▓ро╛, рокропрогроорпН, рооро▓рпИ, ро╕рпНроХрпА
ЁЯЪб	aerial, cable, car, gondola, ropeway, tramway, роПро░ро┐ропро▓рпН, роХро╛ро░рпН, роХрпЗрокро┐ро│рпН, роХрпКрогрпНроЯрпЛро▓ро╛, роЯро┐ро░ро╛роорпНро╡рпЗ, ро░рпЛрокрпН, ро╡ро┐ройрпНроЪрпН
ЁЯЪв	boat, passenger, ship, travel, роХроЯро▓рпН, роХрокрпНрокро▓рпН, роЯрпИроЯрпНроЯро╛ройро┐роХрпН, рокропрогроорпН, ро╖ро┐рокрпН
ЁЯЪг	boat, canoe, cruise, fishing, lake, oar, paddle, person, raft, river, row, rowboat, rowing, роЖро▒рпБ, роПро░ро┐, родрпБроЯрпБрокрпНрокрпБ, родрпЛрогро┐, роирокро░рпН, рокроЯроХрпБ, рокро░ро┐роЪро▓рпН
ЁЯЪгтАНтЩАя╕П	boat, canoe, cruise, fishing, lake, oar, paddle, raft, river, row, rowboat, rowing, woman, роЖро▒рпБ, роПро░ро┐, роУроЯроорпН, родрпБроЯрпБрокрпНрокрпБ, рокроЯроХрпБ, рокроЯроХрпЛроЯрпНроЯро┐, рокроЯроХрпЛроЯрпНроЯрпБроорпН, рокро┐роЯро┐родрпНродро▓рпН, рокрпЖрогрпН, роорпАройрпН, роорпАройрпНрокро┐роЯро┐
ЁЯЪгтАНтЩВя╕П	boat, canoe, cruise, fishing, lake, man, oar, paddle, raft, river, row, rowboat, rowing, роЖрогрпН, рокроЯроХрпБ, рокроЯроХрпЛроЯрпНроЯрпБроорпН
ЁЯЪд	billionaire, boat, lake, luxury, millionaire, speedboat, summer, travel, роЕродро┐ро╡рпЗроХ, роХроЯро▓рпН, рокроЯроХрпБ, рокропрогроорпН, рокрпЛроЯрпН, ро╕рпНрокрпАроЯрпН
ЁЯЪе	horizontal, intersection, light, signal, stop, stoplight, traffic, роХро┐роЯрпИроороЯрпНроЯ, роЪро┐роХрпНройро▓рпНроХро│рпН, роЯро┐ро░ро╛роГрокро┐роХрпН, роЯрпНро░ро╛роГрокро┐роХрпН, рокрпЛроХрпНроХрпБро╡ро░родрпНродрпБ, ро▓рпИроЯрпНроЯрпБ, ро▓рпИроЯрпНроЯрпБроХро│рпН, ро╡ро┐ро│роХрпНроХрпБроХро│рпН
ЁЯЪж	drove, intersection, light, signal, stop, stoplight, traffic, vertical, роЪро┐роХрпНройро▓рпНроХро│рпН, роЪрпЖроЩрпНроХрпБродрпНродрпБ, роЯрпНро░ро╛роГрокро┐роХрпН, рокрпЛроХрпНроХрпБро╡ро░родрпНродрпБ, ро▓рпИроЯрпНроЯрпБроХро│рпН, ро╡ро┐ро│роХрпНроХрпБ, ро╡ро┐ро│роХрпНроХрпБроХро│рпН
ЁЯЪз	barrier, construction, роХроЯрпНроЯрпБрооро╛рой, роЪро┐ройрпНройроорпН, родроЯрпБрокрпНрокрпБ, роироЯрпИрокрпЖро▒рпБроХро┐ро▒родрпБ, рокрогро┐
ЁЯЪи	alarm, alert, beacon, car, emergency, light, police, revolving, siren, роЕро▓ро╛ро░роорпН, роХро╛ро░ро┐ройрпН, роХро╛ро░рпНроХро│ро┐ро▓рпН, роЪрпБро┤ро▓рпБроорпН, роЪрпИро░ройрпН, рокрпЛро▓рпАро╕рпН, ро╡рогрпНроЯро┐, ро╡ро┐ро│роХрпНроХрпБ
ЁЯЪк	back, closet, door, front, роХродро╡рпБ, рокро┐ройрпН, рооро░роХрпНроХродро╡рпБ, рооро░рокрпНрокрпКро░рпБро│рпН, роорпБроЯро┐роирпНродродрпБ, роорпБройрпН, роорпВроЯрпБ
ЁЯЪм	cigarette, smoking, роЪро┐роХро░рпЖроЯрпН, роЪро┐ройрпНройроорпН, рокрпБроХрпИ, рокрпБроХрпИроЪрпН, рокрпБроХрпИродрпНродро▓рпН, рокрпБроХрпИропро┐ро▓рпИ
ЁЯЪ▓я╕П	bicycle, bike, clas, class, cycle, cycling, cyclist, gang, ride, spin, spinning, роЙроЯро▒рпНрокропро┐ро▒рпНроЪро┐, роЪро╡ро╛ро░ро┐, роЪрпИроХрпНроХро┐ро│ро┐роЩрпН, роЪрпИроХрпНроХро┐ро│рпН, рооро┐родро┐ро╡рогрпНроЯро┐, ро╡рогрпНроЯро┐
ЁЯЪ┤	bicycle, bicyclist, bike, biking, cycle, cyclist, person, riding, sport, роЙроЯро▒рпНрокропро┐ро▒рпНроЪро┐, роУроЯрпНроЯрпБродро▓рпН, роУроЯрпНроЯрпБрокро╡ро░рпН, роЪро╡ро╛ро░ро┐, роЪрпИроХрпНроХро┐ро│ро┐роЩрпН, роЪрпИроХрпНроХро┐ро│рпН, роирокро░рпН, рокропрогроорпН, рокрпИроХрпНроХро┐роЩрпН, ро╡ро┐ро│рпИропро╛роЯрпНроЯрпБ
ЁЯЪ┤тАНтЩАя╕П	bicycle, bicyclist, bike, biking, cycle, cyclist, riding, sport, woman, роУроЯрпНроЯрпБродро▓рпН, роУроЯрпНроЯрпБроорпН, роЪро╡ро╛ро░ро┐, роЪрпИроХрпНроХро┐ро│рпН, роирокро░рпН, рокрпЖрогрпН, рокрпИроХрпНроХро┐роЩрпН, ро╡ро┐ро│рпИропро╛роЯрпНроЯрпБ
ЁЯЪ┤тАНтЩВя╕П	bicycle, bicyclist, bike, biking, cycle, cyclist, man, riding, sport, роЖрогрпН, роУроЯрпНроЯрпБродро▓рпН, роУроЯрпНроЯрпБроорпН, роЪрпИроХрпНроХро┐ро│рпН
ЁЯЪ╡	bicycle, bicyclist, bike, biking, cycle, cyclist, mountain, person, riding, sport, роЖрогрпН, роУроЯрпНроЯрпБродро▓рпН, роУроЯрпНроЯрпБрокро╡ро░рпН, роЪро╡ро╛ро░ро┐, роЪро╛роХроЪроорпН, роЪрпИроХрпНроХро┐ро│ро┐ро╕рпНроЯрпН, роЪрпИроХрпНроХро┐ро│рпН, рооро▓рпИ, рооро▓рпИрокрпНрокро╛родрпИ, рооро▓рпИрокрпНрокро╛родрпИропро┐ро▓рпН, ро╡ро┐ро│рпИропро╛роЯрпНроЯрпБ
ЁЯЪ╡тАНтЩАя╕П	bicycle, bicyclist, bike, biking, cycle, cyclist, mountain, riding, sport, woman, роУроЯрпНроЯрпБродро▓рпН, роУроЯрпНроЯрпБроорпН, роЪро╛роХроЪроорпН, роЪрпИроХрпНроХро┐ро│рпН, роирокро░рпН, рокро╛родрпИ, рокрпЖрогрпН, рооро▓рпИ, рооро▓рпИрокрпН, рооро▓рпИрокрпНрокро╛родрпИ, рооро▓рпИрокрпНрокро╛родрпИропро┐ро▓рпН, ро╡ро┐ро│рпИропро╛роЯрпНроЯрпБ
ЁЯЪ╡тАНтЩВя╕П	bicycle, bicyclist, bike, biking, cycle, cyclist, man, mountain, riding, sport, роЖрогрпН, роУроЯрпНроЯрпБродро▓рпН, роУроЯрпНроЯрпБроорпН, роЪрпИроХрпНроХро┐ро│рпН, рокро╛родрпИ, рооро▓рпИрокрпН, рооро▓рпИрокрпНрокро╛родрпИропро┐ро▓рпН
ЁЯЪ╢	amble, gait, hike, man, pace, pedestrian, person, stride, stroll, walk, walking, роЖрогрпН, роЪрпЖро▓рпНрокро╡ро░рпН, роироЯродрпНродро▓рпН, роироЯроирпНродрпБ, роироЯрокрпНрокро╡ро░рпН, роироЯрпИ, роирокро░рпН, рокропрогроорпН, рокро╛родроЪро╛ро░ро┐
ЁЯЪ╢тАНтЩАя╕П	amble, gait, hike, man, pace, pedestrian, stride, stroll, walk, walking, woman, роЙро▓ро╛, роЪрпЖро▓рпНро▓рпБроорпН, роироЯродрпНродро▓рпН, роироЯроирпНродрпБ, роироЯрокрпНрокро╡ро░рпН, роироЯрпИ, роирокро░рпН, рокропрогроорпН, рокро╛родроЪро╛ро░ро┐, рокрпЖрогрпН
ЁЯЪ╢тАНтЩАя╕ПтАНтЮбя╕П	amble, facing, gait, hike, man, pace, pedestrian, right, stride, stroll, walk, walking, woman
ЁЯЪ╢тАНтЩВя╕П	amble, gait, hike, man, pace, pedestrian, stride, stroll, walk, walking, роЖрогрпН, роЪрпЖро▓рпНро▓рпБроорпН, роироЯроирпНродрпБ, роироЯрокрпНрокро╡ро░рпН, роироЯрпИ, рокропрогроорпН
ЁЯЪ╢тАНтЩВя╕ПтАНтЮбя╕П	amble, facing, gait, hike, man, pace, pedestrian, right, stride, stroll, walk, walking
ЁЯЪ╢тАНтЮбя╕П	amble, facing, gait, hike, man, pace, pedestrian, person, right, stride, stroll, walk, walking
ЁЯЪ╜	bathroom, toilet, роХро┤ро┐рокрпНрокро▒рпИ, роХро┤ро┐ро╡ро▒рпИ, роЯро╛ропрпНро▓роЯрпН, роЯро╛ропрпНро▓рпЖроЯрпН, рокро╛родрпНро░рпВроорпН, ро░рпВроорпН, ро░рпЖро╕рпНроЯрпН
ЁЯЪ┐	shower, water, роХрпБро│ро┐, роХрпБро│ро┐ропро▓рпН, родрогрпНрогрпАро░рпН, рокро╛родрпН, рокрпБродрпНродрпБрогро░рпНроЪрпНроЪро┐, ро╖ро╡ро░рпН
ЁЯЫА	bath, bathtub, person, taking, tub, роХрпБро│ро┐ропро▓рпН, родрпКроЯрпНроЯро┐, роирокро░рпН
ЁЯЫБ	bath, bathtub, роХрпБро│ро┐, роХрпБро│ро┐ропро▓ро▒рпИ, роХрпБро│ро┐ропро▓рпН, роЪрпКроХрпБроЪрпБ, родрпКроЯрпНроЯро┐, роирпБро░рпИ, рокрокрпБро│рпН, рокрпКро░рпБро│рпН
ЁЯЫМ	bed, bedtime, good, goodnight, hotel, in, nap, night, person, sleep, tired, zzz, роЗройро┐роп, роЗро░ро╡рпБ, роЙро▒роХрпНроХроорпН, роЙро▒роЩрпНроХрпБроорпН, роЪрпЛро░рпНро╡рпБ, родрпВроХрпНроХроорпН, роирпЗро░роорпН, рокроЯрпБроХрпНроХрпИропро┐ро▓рпН, рокроЯрпБродрпНродро┐ро░рпБрокрпНрокро╡ро░рпН, ро╡ро┐роЯрпБродро┐, ро╣рпЛроЯрпНроЯро▓рпН
ЁЯЫС	octagonal, stop, роОрогрпНроХрпЛрогроорпН, роОрогрпНроорпБроХроорпН, роиро┐ро▒рпБродрпНродроорпН, роиро┐ро▒рпБродрпНродрпБ, роиро┐ро▓рпН
ЁЯЫТ	cart, shopping, trolley, роХро╛ро░рпНроЯрпН, роХрпВроЯрпИ, роЪроХрпНроХро░, роЯро┐ро░ро╛ро▓ро┐, рокрпКро░рпБро│рпН, ро╡рогрпНроЯро┐, ро╖ро╛рокрпНрокро┐роЩрпН
ЁЯЫХ	hindu, temple, роЖройрпНроорпАроХроорпН, роЖро▓ропроорпН, роЗроирпНродрпБ, роХрпЛрокрпБро░роорпН, роХрпЛропро┐ро▓рпН, роХрпЛро╡ро┐ро▓рпН, родрпЖропрпНро╡рпАроХроорпН, рокро┐ро░ро╛ро░рпНродрпНродройрпИ, ро╡ро┤ро┐рокро╛роЯрпБ
ЁЯЫЦ	home, house, hut, roundhouse, shelter, yurt, роХрпБроЯро┐роЪрпИ, роХрпБроЯро┐ропро┐ро░рпБрокрпНрокрпБ, роХрпВроЯро╛ро░роорпН, роХрпВро░рпИ, ропро░рпНроЯрпН, ро░ро╡рпБрогрпНроЯрпНро╣ро╡рпБро╕рпН, ро╡роЪро┐рокрпНрокро┐роЯроорпН, ро╡рпАроЯрпБ
ЁЯЫЧ	accessibility, elevator, hoist, lift, роЕрогрпБроХро▓рпНродройрпНроорпИ, роОро▓ро╡рпЗроЯрпНроЯро░рпН, роОро▓ро┐ро╡рпЗроЯрпНроЯро░рпН, роПро▒рпНро▒рпБродро▓рпН, рооро┐ройрпНродрпВроХрпНроХро┐, ро▓ро┐роГрокрпНроЯрпН
ЁЯЫЭ	amusement, park, play, playground, playing, slide, sliding, theme, роЪро▒рпБроХрпНроХрпБ, роЪро▒рпБроХрпНроХрпБродро▓рпН, рокро╛ро░рпНроХрпН, рокрпВроЩрпНроХро╛, рокрпКро┤рпБродрпБрокрпЛроХрпНроХрпБ, роорпИродро╛ройроорпН, ро╡ро┐ро│рпИропро╛роЯрпНроЯрпБ
ЁЯЫЮ	car, circle, tire, turn, vehicle, wheel, роХро╛ро░рпН, роЪроХрпНроХро░роорпН, роЯропро░рпН, родро┐ро░рпБрокрпНрокрпБродро▓рпН, ро╡роЯрпНроЯроорпН, ро╡ро╛роХройроорпН
ЁЯЫЯ	buoy, float, life, lifesaver, preserver, rescue, ring, safety, save, saver, swim, роЙропро┐ро░рпН, роЙропро┐ро░рпНроХро╛рокрпНрокро╛ройрпН, роХро╛рокрпНрокро╛ройрпН, роХро╛рокрпНрокро╛ро▒рпНро▒рпБ, роирпАроЪрпНроЪро▓рпН, рокро╛родрпБроХро╛рокрпНрокрпБ, рооро┐родро╡рпИ, роорпАроЯрпНрокрпБ, ро╡роЯрпНроЯ
ЁЯЫл	aeroplane, airplane, check, departure, departures, in, plane, роЖроГрокрпН, роЗройрпН, роЪрпЖроХрпН, роЯрпЗроХрпН, рокро▒родрпНродро▓рпН, рокро┐ро│рпИроЯрпН, рокрпБро▒рокрпНрокроЯрпБродро▓рпН, рокрпБро▒рокрпНрокро╛роЯрпБ, ро╡ро┐рооро╛ройроорпН
ЁЯЫм	aeroplane, airplane, arrival, arrivals, arriving, landing, plane, родро░рпИропро┐ро▒роЩрпНроХрпБродро▓рпН, рокро┐ро│рпИроЯрпН, ро▓рпЗрогрпНроЯро┐роЩрпН, ро╡ро░рпБроХрпИ, ро╡ро┐рооро╛рой, ро╡ро┐рооро╛ройроорпН
ЁЯЫ┤	kick, scooter, роХро┐роХрпН, ро╕рпНроХрпВроЯрпНроЯро░рпН
ЁЯЫ╡	motor, scooter, роЗро░рпБроЪроХрпНроХро░, рокроЬро╛роЬрпН, рокро┐ропро╛роЬро┐ропрпЛ, роорпЛроЯрпНроЯро╛ро░рпН, ро╡ро╛роХройроорпН, ро╡рпЖро╕рпНрокро╛, ро╕рпНроХрпВроЯрпНроЯро░рпН
ЁЯЫ╢	boat, canoe, роУроЯроорпН, родрпБроЯрпБрокрпНрокрпБ, рокроЯроХрпБ
ЁЯЫ╖	luge, sled, sledge, sleigh, snow, toboggan, роХро┐ро▒ро┐ро╕рпНродрпБрооро╕рпН, роЪро╛ройрпНроЯро╛роХро┐ро│ро╛ро╕рпН, рокройро┐, рокройро┐роЪрпНроЪро▒рпБроХрпНроХрпБ, ро╡рогрпНроЯро┐, ро╡ро╛роХройроорпН, ро╕рпНро▓рпЖроЯрпНроЬрпН, ро╕рпНро▓рпЗропрпН
ЁЯЫ╕	alien, aliens, extra, flying, saucer, terrestrial, ufo, роОроГрокрпН, роПро▓ро┐ропройрпН, родроЯрпНроЯрпБ, рокро▒роХрпНроХрпБроорпН, рооройро┐родро░рпНроХро│рпН, ропрпБроОроГрокрпНроУ, ропрпВ, ро╡ро┐рогрпНро╡рпЖро│ро┐, ро╡рпЗро▒рпНро▒рпБроХро┐ро░роХ
ЁЯЫ╣	board, skate, skateboard, skater, wheel, wheels, роЪро▒рпБроХрпНроХро▓рпН, роЪро▒рпБроХрпНроХрпБ, рокрпЛро░рпНроЯрпБ, ро╕рпНроХрпЗроЯрпН, ро╕рпНроХрпЗроЯрпНроЯро░рпН, ро╕рпНроХрпЗроЯрпНроЯро┐роЩрпН, ро╕рпНроХрпЗроЯрпНрокрпЛро░рпНроЯрпБ
ЁЯЫ║	auto, rickshaw, tuk, роЖроЯрпНроЯрпЛ, роЪроХрпНроХро░, роороЮрпНроЪро│рпН, роорпВройрпНро▒рпБ, ро░ро┐роХрпН, ро╡ро╛роХройроорпН, ро╖ро╛
ЁЯЫ╗	automobile, car, flatbed, pick, pickup, transportation, truck, up, роЖроЯрпНроЯрпЛроорпКрокрпИро▓рпН, роЯро┐ро░роХрпН, рокро┐роХрпНроЕрокрпН, рокро┐роХрпНроХрокрпН, рокрпЛроХрпНроХрпБро╡ро░родрпНродрпБ, ро▓ро╛ро░ро┐, ро╡ро╛роХройроорпН
ЁЯЫ╝	blade, blades, roller, skate, skates, sport, ро░рпЛро▓ро░рпН, ро╡ро┐ро│рпИропро╛роЯрпНроЯрпБ, ро╖рпВ, ро╕рпНроХрпЗроЯрпН, ро╕рпНроХрпЗроЯрпНроЯро┐роЩрпН
ЁЯЫШ	avalanche, danger, disaster, earthquake, landslide, mountain, mudslide, rock, rocks, роЖрокродрпНродрпБ, роЪро░ро┐ро╡рпБ, роиро┐ро▓роироЯрпБроХрпНроХроорпН, рокройро┐рокрпНрокро╛ро▒рпИроЪрпН, рокро╛ро▒рпИроХро│рпН, рокрпЗро░ро┐роЯро░рпН, роорогрпН, рооро▓рпИ, рооро▓рпИроЪрпН
ЁЯкК	bras, brass, instrument, jazz, music, sad, slide, trombone, роЗроЪрпИ, роЗроЪрпИроХрпНроХро░рпБро╡ро┐, роЬро╛ро╕рпН, родро╛рооро┐ро░роорпН
ЁЯкО	chest, gem, gold, jewel, jewels, loot, money, prize, silver, treasure, valuable, valuables, wealth, роХрпКро│рпНро│рпИ, роЪрпЖро▓рпНро╡роорпН, родроЩрпНроХроорпН, роироХрпИроХро│рпН, рокрогроорпН, рокро░ро┐роЪрпБ, роородро┐рокрпНрокрпБрооро┐роХрпНроХро╡рпИ, ро░родрпНродро┐ройроорпН, ро╡рпЖро│рпНро│ро┐
ЁЯлН	marine, ocean, orca, whale, роЙропро┐ро░ро┐ройроорпН, роХроЯро▓рпН, роХроЯро▓рпНро╡ро╛ро┤рпН, родро┐рооро┐роЩрпНроХро▓роорпН, рокрпЖро░рпБроЩрпНроХроЯро▓рпН
